,date_kotirovki,close,PhysicalLong,PhysicalShort,JuridicalLong,JuridicalShort,putov_summa,PhysicalLong_liza,PhysicalShort_liza,JuridicalLong_liza,JuridicalShort_liza,putov_summa_liza
0,2013-01-08,30.212,562005,89287,840758,1313476,2805526,3025,699,299,131,4154
1,2013-01-09,30.36,543661,118760,882360,1307261,2852042,3124,818,320,146,4408
2,2013-01-10,30.191,634162,165779,906134,1374517,3080592,3345,954,326,159,4784
3,2013-01-11,30.3145,587328,178594,910605,1319339,2995866,3292,971,334,146,4743
4,2013-01-14,30.254,583739,192934,815156,1205961,2797790,3404,955,350,157,4866
5,2013-01-15,30.3475,586056,154891,781885,1213050,2735882,3583,913,355,159,5010
6,2013-01-16,30.311,581956,174260,825901,1233597,2815714,3529,892,353,158,4932
7,2013-01-17,30.1945,599394,184267,789062,1204189,2776912,3576,1018,352,175,5121
8,2013-01-18,30.27,633184,177581,785474,1241077,2837316,3736,880,354,179,5149
9,2013-01-21,30.268,608286,199462,802816,1211640,2822204,3689,958,357,168,5172
10,2013-01-22,30.225,671284,156100,795722,1310906,2934012,3884,945,358,169,5356
11,2013-01-23,30.162,661308,156823,819941,1324426,2962498,3880,1032,348,180,5440
12,2013-01-24,30.0735,680589,162120,829034,1347503,3019246,3937,1057,350,166,5510
13,2013-01-25,30.0325,673211,198176,836794,1311829,3020010,3846,1071,354,161,5432
14,2013-01-28,30.1675,611694,215051,874522,1271165,2972432,3784,951,353,174,5262
15,2013-01-29,30.035,621630,182817,870494,1309307,2984248,3934,969,356,164,5423
16,2013-01-30,30.0175,670136,194738,877456,1352854,3095184,4140,945,366,155,5606
17,2013-01-31,30.026,643414,148170,876439,1371683,3039706,4156,772,370,149,5447
18,2013-02-01,29.86,648604,148573,899653,1399684,3096514,3946,1014,355,161,5476
19,2013-02-04,30.0875,641263,133489,887297,1395071,3057120,4059,938,364,166,5527
20,2013-02-05,29.95,613518,142799,881855,1352574,2990746,4006,953,354,169,5482
21,2013-02-06,30.088,639309,141580,875098,1372827,3028814,4142,885,373,155,5555
22,2013-02-07,30.188,656083,131596,858686,1383173,3029538,4097,893,357,167,5514
23,2013-02-08,30.1745,651646,124765,843582,1370463,2990456,3933,876,357,166,5332
24,2013-02-11,30.165,698376,110508,804692,1392560,3006136,4176,800,361,155,5492
25,2013-02-12,30.04,661930,131860,827287,1357357,2978434,3952,1018,354,175,5499
26,2013-02-13,30.056,648764,133403,831680,1347041,2960888,3875,1072,341,179,5467
27,2013-02-14,30.1,669626,125389,839446,1383683,3018144,4093,819,381,153,5446
28,2013-02-15,30.134,668870,121569,841176,1388477,3020092,4025,833,366,160,5384
29,2013-02-18,30.134,656392,117427,843779,1382744,3000342,4061,843,364,154,5422
30,2013-02-19,30.076,654014,118114,836291,1372191,2980610,3995,921,354,162,5432
31,2013-02-20,30.1935,665562,126112,839491,1378941,3010106,4118,844,361,153,5476
32,2013-02-21,30.4865,709009,159335,913487,1463161,3244992,4523,965,384,151,6023
33,2013-02-22,30.4225,706144,131451,948444,1523137,3309176,4575,877,377,154,5983
34,2013-02-25,30.507,752977,165425,952834,1540386,3411622,4759,944,373,174,6250
35,2013-02-26,30.6345,667610,161412,923114,1429312,3181448,4157,1132,373,156,5818
36,2013-02-27,30.5325,691648,163192,886675,1415131,3156646,4254,1112,375,153,5894
37,2013-02-28,30.561,695434,164055,929576,1460955,3250020,4269,1048,386,147,5850
38,2013-03-01,30.699,735396,165181,914507,1484722,3299806,4311,1033,382,142,5868
39,2013-03-04,30.734,728089,168324,858721,1418486,3173620,4110,1137,359,161,5767
40,2013-03-05,30.616,684451,172336,832921,1345036,3034744,3855,1228,347,168,5598
41,2013-03-06,30.721,665789,205365,827162,1287586,2985902,4092,1118,363,156,5729
42,2013-03-07,30.6975,649810,222472,852111,1279449,3003842,3840,1144,358,166,5508
43,2013-03-11,30.7175,626181,201158,814507,1239530,2881376,3724,1208,350,161,5443
44,2013-03-12,30.701,655556,200381,830251,1285426,2971614,3771,1221,337,171,5500
45,2013-03-13,30.794,618165,185343,856815,1289637,2949960,3612,1163,355,155,5285
46,2013-03-14,30.72,635012,196868,890897,1329041,3051818,3448,1159,323,161,5091
47,2013-03-15,30.657,519970,128028,780881,1172823,2601702,2755,767,259,130,3911
48,2013-03-18,30.835,542988,143914,846077,1245151,2778130,2997,725,279,120,4121
49,2013-03-19,30.9855,550379,152035,761176,1159520,2623110,3131,811,279,124,4345
50,2013-03-20,30.85,545009,174701,761409,1131717,2612836,3161,860,288,142,4451
51,2013-03-21,30.9345,551134,164694,736913,1123353,2576094,3251,816,299,127,4493
52,2013-03-22,30.837,617915,181410,744348,1180853,2724526,3394,821,299,134,4648
53,2013-03-25,30.924,641616,178184,730726,1194158,2744684,3509,818,299,124,4750
54,2013-03-26,30.852,602354,184335,739698,1157717,2684104,3306,877,298,130,4611
55,2013-03-27,31.04,583547,177652,772707,1178602,2712508,3153,1057,319,126,4655
56,2013-03-28,31.0965,629640,179637,784329,1234332,2827938,3079,1022,290,133,4524
57,2013-03-29,31.06,638451,172869,822879,1288461,2922660,3187,950,295,128,4560
58,2013-04-01,31.0845,662613,190957,797771,1269427,2920768,3152,1026,301,139,4618
59,2013-04-02,31.3205,644146,214727,775232,1204651,2838756,3090,1217,316,135,4758
60,2013-04-03,31.644,642486,238098,713200,1117588,2711372,2938,1503,303,159,4903
61,2013-04-04,31.585,603992,227373,677439,1054058,2562862,2784,1493,272,173,4722
62,2013-04-05,31.52,656191,223260,645413,1078344,2603208,2920,1229,279,158,4586
63,2013-04-08,31.2195,774801,192112,608587,1191276,2766776,3411,1038,299,158,4906
64,2013-04-09,31.0205,770206,165413,606232,1211025,2752876,3465,894,325,141,4825
65,2013-04-10,30.884,820008,179847,743777,1383938,3127570,3837,876,344,143,5200
66,2013-04-11,30.884,888316,174869,721163,1434610,3218958,4120,788,363,126,5397
67,2013-04-12,31.085,904478,183049,753394,1474823,3315744,4217,657,383,119,5376
68,2013-04-15,31.45,790465,109913,757419,1437971,3095768,3764,752,367,115,4998
69,2013-04-16,31.263,772794,107783,704956,1369967,2955500,3496,859,341,130,4826
70,2013-04-17,31.886,688574,121125,677575,1245024,2732298,3455,1003,348,134,4940
71,2013-04-18,31.55,734564,127510,708750,1315804,2886628,3359,976,314,152,4801
72,2013-04-19,31.6635,728443,136071,678907,1271279,2814700,3382,961,315,163,4821
73,2013-04-22,31.553,779943,162913,709685,1326715,2979256,3530,942,334,151,4957
74,2013-04-23,31.6235,714129,197137,827777,1344769,3083812,3302,1065,315,149,4831
75,2013-04-24,31.46,713433,185746,810088,1337775,3047042,3240,1136,311,142,4829
76,2013-04-25,31.173,797069,129794,693343,1360618,2980824,3656,888,334,132,5010
77,2013-04-26,31.254,756889,115968,718362,1359283,2950502,3630,889,332,128,4979
78,2013-04-29,30.927,824870,163937,768140,1429073,3186020,4038,951,340,161,5490
79,2013-04-30,31.121,785925,155271,896019,1526673,3363888,3979,781,356,136,5252
80,2013-05-02,31.173,718748,144479,941528,1515797,3320552,3779,716,351,124,4970
81,2013-05-03,31.053,699250,142878,918514,1474886,3235528,3807,815,327,152,5101
82,2013-05-06,31.04,761452,126042,906275,1541685,3335454,4126,704,353,143,5326
83,2013-05-07,31.0565,771080,104333,870408,1537155,3282976,4047,841,358,146,5392
84,2013-05-08,31.118,725001,89167,862082,1497916,3174166,4211,677,362,135,5385
85,2013-05-10,31.36,714766,101733,911033,1524066,3251598,4025,694,380,124,5223
86,2013-05-13,31.3475,689699,119477,853473,1423695,3086344,4139,738,384,132,5393
87,2013-05-14,31.356,687545,112466,835076,1410155,3045242,4058,796,374,135,5363
88,2013-05-15,31.45,746265,151587,853272,1447950,3199074,3955,900,387,135,5377
89,2013-05-16,31.3615,751586,117643,814896,1448839,3132964,3910,948,354,160,5372
90,2013-05-17,31.421,681140,111601,830045,1399584,3022370,3827,808,363,141,5139
91,2013-05-20,31.252,667070,110816,812946,1369200,2960032,3658,1089,343,155,5245
92,2013-05-21,31.238,672562,93445,786085,1365202,2917294,3878,876,362,145,5261
93,2013-05-22,31.425,669589,97154,801130,1373565,2941438,3787,981,341,160,5269
94,2013-05-23,31.407,691004,99115,826986,1418875,3035980,3874,812,365,137,5188
95,2013-05-24,31.32,716032,113822,848460,1450670,3128984,3964,744,370,143,5221
96,2013-05-27,31.362,703149,110201,861434,1454382,3129166,3950,823,364,139,5276
97,2013-05-28,31.515,685618,131363,910970,1465225,3193176,3929,824,379,135,5267
98,2013-05-29,31.5925,715589,136581,951742,1530750,3334662,3824,987,360,148,5319
99,2013-05-30,31.727,674622,147621,931874,1458875,3212992,3767,1069,372,143,5351
100,2013-05-31,31.952,618502,159759,1017073,1475816,3271150,3440,1241,369,155,5205
101,2013-06-03,31.779,625602,168585,995790,1452807,3242784,3095,1363,332,173,4963
102,2013-06-04,31.905,539897,148183,990531,1382245,3060856,3273,1291,346,164,5074
103,2013-06-05,32.165,499369,163671,980901,1316599,2960540,3088,1446,335,168,5037
104,2013-06-06,32.12,481946,222484,1063626,1323088,3091144,3084,1473,334,173,5064
105,2013-06-07,32.1675,501861,193195,990657,1299323,2985036,2887,1494,296,177,4854
106,2013-06-10,32.307,431773,204815,828486,1055444,2520518,2869,1575,301,176,4921
107,2013-06-11,32.394,455867,138481,793492,1110878,2498718,2904,1420,291,189,4804
108,2013-06-13,31.948,416082,119993,737769,1033858,2307702,2851,1296,275,196,4618
109,2013-06-14,31.729,432911,116521,809832,1126222,2485486,2996,1079,303,190,4568
110,2013-06-17,31.7375,361651,91791,651384,921244,2026070,2355,786,256,122,3519
111,2013-06-18,32.005,363422,151532,694339,906229,2115522,2430,1076,274,136,3916
112,2013-06-19,32.469,370854,140653,708367,938568,2158442,2672,1054,276,155,4157
113,2013-06-20,33.046,293736,194831,657935,756840,1903342,2366,1506,252,170,4294
114,2013-06-21,32.783,324629,158756,615705,781578,1880668,2400,1434,238,192,4264
115,2013-06-24,32.71,301846,179697,648494,770643,1900680,2469,1498,250,188,4405
116,2013-06-25,32.81,327951,200670,630226,757507,1916354,2408,1538,246,203,4395
117,2013-06-26,32.955,293682,208157,642130,727655,1871624,2420,1665,247,205,4537
118,2013-06-27,32.7995,289456,172425,620989,738020,1820890,2322,1611,228,213,4374
119,2013-06-28,32.803,320636,169790,599256,750102,1839784,2332,1521,246,207,4306
120,2013-07-01,32.972,302199,208359,633442,727282,1871282,2358,1627,265,201,4451
121,2013-07-02,33.1505,296526,272007,639519,664038,1872090,2447,1759,277,219,4702
122,2013-07-03,33.1295,338614,258707,596510,676417,1870248,2432,1892,282,228,4834
123,2013-07-04,33.192,333804,267922,587963,653845,1843534,2405,1903,274,227,4809
124,2013-07-05,33.3245,356013,268678,564003,651338,1840032,2428,1901,261,229,4819
125,2013-07-08,33.2235,334343,253770,566824,647397,1802334,2299,2075,243,247,4864
126,2013-07-09,32.9935,356221,213936,566288,708573,1845018,2417,1761,253,222,4653
127,2013-07-10,32.898,360459,224609,504601,640451,1730120,2556,1675,261,223,4715
128,2013-07-11,32.514,302269,209722,507177,599724,1618892,2467,1482,269,207,4425
129,2013-07-12,32.64,350355,192630,467280,625005,1635270,2613,1339,285,194,4431
130,2013-07-15,32.575,323973,207467,483584,600090,1615114,2778,1318,296,195,4587
131,2013-07-16,32.4,321669,214751,482106,589024,1607550,2848,1405,288,214,4755
132,2013-07-17,32.3395,362406,182088,478614,658932,1682040,2934,1316,294,210,4754
133,2013-07-18,32.49,425070,145695,576122,855497,2002384,3337,1066,310,193,4906
134,2013-07-19,32.3115,421819,160163,676444,938100,2196526,3205,1150,309,200,4864
135,2013-07-22,32.338,353658,173959,667729,847428,2042774,2710,1130,305,198,4343
136,2013-07-23,32.3045,381615,162866,670005,888754,2103240,2992,1007,327,182,4508
137,2013-07-24,32.4605,418479,168533,736976,986922,2310910,3067,974,325,181,4547
138,2013-07-25,32.6185,456652,166758,782091,1071985,2477486,3152,925,347,184,4608
139,2013-07-26,32.7895,412439,184674,852745,1080510,2530368,2879,1004,337,173,4393
140,2013-07-29,32.8295,415074,159714,882745,1138105,2595638,2735,1085,320,172,4312
141,2013-07-30,32.9635,413244,152689,880312,1140867,2587112,2800,1094,334,169,4397
142,2013-07-31,32.9795,354257,151264,871943,1074936,2452400,2557,1186,310,176,4229
143,2013-08-01,33.074,327958,182634,859898,1005222,2375712,2189,1489,283,204,4165
144,2013-08-02,32.8475,333347,167577,676361,842131,2019416,2130,1424,264,208,4026
145,2013-08-05,32.9055,307450,194902,624047,736595,1862994,2173,1404,272,208,4057
146,2013-08-06,32.963,354994,162275,602539,795258,1915066,2407,1240,287,207,4141
147,2013-08-07,32.9745,373556,170471,608564,811649,1964240,2487,1242,297,213,4239
148,2013-08-08,32.8375,353295,162881,607763,798177,1922116,2383,1357,285,220,4245
149,2013-08-09,32.8855,345195,187046,633997,792146,1958384,2345,1360,280,223,4208
150,2013-08-12,32.997,362205,191371,629943,800777,1984296,2464,1337,304,218,4323
151,2013-08-13,33.1,332872,207110,607069,732831,1879882,2434,1401,309,213,4357
152,2013-08-14,33.0825,393769,205237,595127,783659,1977792,2730,1610,297,248,4885
153,2013-08-15,32.88,437696,184295,605272,858673,2085936,2932,1372,281,226,4811
154,2013-08-16,32.901,438760,166082,652678,925356,2182876,3199,1348,295,223,5065
155,2013-08-19,32.98,454004,166069,687977,975912,2283962,3205,1318,297,218,5038
156,2013-08-20,32.956,465494,160074,663830,969250,2258648,3163,1371,308,220,5062
157,2013-08-21,33.123,479291,152831,691442,1017902,2341466,3280,1246,319,207,5052
158,2013-08-22,33.057,449422,193023,720788,977187,2340420,2993,1454,296,227,4970
159,2013-08-23,33.015,455062,207799,689886,937149,2289896,3033,1412,279,226,4950
160,2013-08-26,33.0695,454114,196019,708199,966294,2324626,3104,1409,285,242,5040
161,2013-08-27,33.1775,492383,171011,766517,1087889,2517800,3102,1452,291,237,5082
162,2013-08-28,33.21,462549,166603,809023,1104969,2543144,3089,1477,293,213,5072
163,2013-08-29,33.25,492641,169285,794810,1118166,2574902,3102,1474,303,218,5097
164,2013-08-30,33.3145,470461,141900,831525,1160086,2603972,3140,1410,325,202,5077
165,2013-09-02,33.345,507583,142508,843638,1208713,2702442,3243,1431,329,205,5208
166,2013-09-03,33.519,451017,180357,793945,1064605,2489924,3177,1583,327,215,5302
167,2013-09-04,33.3475,434612,160661,772342,1046293,2413908,3001,1561,306,224,5092
168,2013-09-05,33.424,404077,165004,787323,1026396,2382800,2804,1545,282,238,4869
169,2013-09-06,33.27,356450,167623,743841,932668,2200582,2616,1626,262,237,4741
170,2013-09-09,33.168,372829,163553,669700,878976,2085058,2695,1601,285,230,4811
171,2013-09-10,32.97,342609,140672,663982,865919,2013182,2619,1390,293,227,4529
172,2013-09-11,32.754,352743,118665,662462,896540,2030410,2672,1229,297,228,4426
173,2013-09-12,32.6345,372271,111060,716706,977917,2177954,2856,1197,303,225,4581
174,2013-09-13,32.48,414233,97916,723839,1040156,2276144,3149,1006,313,191,4659
175,2013-09-16,32.2775,420377,83878,700482,1036981,2241718,2487,829,267,142,3725
176,2013-09-17,32.225,432800,96941,724880,1060739,2315360,2761,869,310,138,4078
177,2013-09-18,31.8215,453203,78301,693638,1068540,2293682,3087,735,339,130,4291
178,2013-09-19,31.6365,484600,61776,766240,1189064,2501680,3326,669,379,133,4507
179,2013-09-20,31.853,505244,65765,772226,1211705,2554940,3508,577,375,129,4589
180,2013-09-23,31.8035,478842,62303,793194,1209733,2544072,3627,678,386,137,4828
181,2013-09-24,31.885,469058,63690,788629,1193997,2515374,3646,623,382,135,4786
182,2013-09-25,32.101,458098,94316,770848,1134630,2457892,3535,646,392,131,4704
183,2013-09-26,32.325,446963,95856,758091,1109198,2410108,3413,774,368,137,4692
184,2013-09-27,32.355,410639,128662,722417,1004394,2266112,2882,980,313,151,4326
185,2013-09-30,32.41,411857,130001,746034,1027890,2315782,2915,1000,318,153,4386
186,2013-10-01,32.227,432336,115643,793102,1109795,2450876,2865,1243,304,205,4617
187,2013-10-02,32.234,489491,105921,814136,1197706,2607254,2938,1150,313,185,4586
188,2013-10-03,32.1445,464948,109082,826721,1182587,2583338,2783,1318,307,201,4609
189,2013-10-04,32.1815,455292,135745,839938,1159485,2590460,2872,1201,322,183,4578
190,2013-10-07,32.265,498193,83577,765844,1180460,2528074,3081,944,348,147,4520
191,2013-10-08,32.405,476693,144395,718622,1050920,2390630,2751,1290,314,198,4553
192,2013-10-09,32.325,492040,104950,688839,1075929,2361758,3094,908,343,150,4495
193,2013-10-10,32.1975,431737,132249,691607,991095,2246688,2822,1169,316,184,4491
194,2013-10-11,32.2855,429750,113280,674829,991299,2209158,2988,964,332,160,4444
195,2013-10-14,32.28,426774,122395,705687,1010066,2264922,2986,937,354,157,4434
196,2013-10-15,32.29,418054,113977,687443,991520,2210994,2909,968,334,151,4362
197,2013-10-16,32.113,408173,141481,689634,956326,2195614,2732,1310,308,198,4548
198,2013-10-17,31.884,450660,130027,666865,987498,2235050,2917,1307,318,206,4748
199,2013-10-18,31.931,462965,132405,697603,1028163,2321136,3153,1123,337,195,4808
200,2013-10-21,31.9475,499268,108813,707249,1097704,2413034,3266,1072,354,182,4874
201,2013-10-22,31.6875,492895,128801,754514,1118608,2494818,3379,1139,343,187,5048
202,2013-10-23,31.77,540283,113241,777785,1204827,2636136,3644,1035,343,188,5210
203,2013-10-24,31.7275,572084,108941,827389,1290532,2798946,3768,1046,353,195,5362
204,2013-10-25,31.762,630341,75041,861130,1416430,2982942,4065,756,398,169,5388
205,2013-10-28,31.911,625570,63442,811839,1373967,2874818,4340,670,411,145,5566
206,2013-10-29,32.088,547590,75261,798214,1270543,2691608,4066,724,410,142,5342
207,2013-10-30,32.0185,548970,69068,777063,1256965,2652066,3741,858,372,165,5136
208,2013-10-31,32.096,540550,63079,789444,1266915,2659988,3793,740,378,157,5068
209,2013-11-01,32.42,532993,111720,820643,1241916,2707272,3408,967,349,178,4902
210,2013-11-05,32.553,506694,138282,822078,1190490,2657544,3287,991,366,165,4809
211,2013-11-06,32.384,435846,112307,854821,1178360,2581334,3112,1081,344,191,4728
212,2013-11-07,32.429,469433,115878,862691,1216246,2664248,2958,1175,339,192,4664
213,2013-11-08,32.6365,502386,116179,870407,1256614,2745586,3628,1164,356,182,5330
214,2013-11-11,32.796,471135,112272,890939,1249802,2724148,3574,1276,368,191,5409
215,2013-11-12,32.8905,467589,162439,847830,1152980,2630838,3312,1538,335,209,5394
216,2013-11-13,32.736,470413,131175,808215,1147453,2557256,3171,1473,315,218,5177
217,2013-11-14,32.66,458988,150257,804346,1113077,2526668,2944,1592,309,238,5083
218,2013-11-15,32.589,456819,168269,820245,1108795,2554128,2900,1742,299,250,5191
219,2013-11-18,32.575,474982,179658,834389,1129713,2618742,2917,1743,303,252,5215
220,2013-11-19,32.746,537475,145515,817750,1209710,2710450,3420,1209,357,195,5181
221,2013-11-20,32.9335,524633,153163,822107,1193577,2693480,3455,1249,358,187,5249
222,2013-11-21,32.992,502296,169135,857724,1190885,2720040,3262,1404,357,208,5231
223,2013-11-22,32.7555,456670,187017,900176,1169829,2713692,3033,1548,317,227,5125
224,2013-11-25,32.934,505270,188163,895788,1212895,2802116,3251,1490,351,217,5309
225,2013-11-26,32.9405,493195,158971,912170,1246394,2810730,3354,1390,362,212,5318
226,2013-11-27,33.18,513656,165907,942265,1290014,2911842,3320,1474,354,221,5369
227,2013-11-28,33.148,461523,180503,959503,1240523,2842052,3224,1621,342,235,5422
228,2013-11-29,33.1555,466079,183115,899973,1182937,2732104,3257,1597,349,217,5420
229,2013-12-02,33.2395,486823,182479,867264,1171608,2708174,3243,1606,336,224,5409
230,2013-12-03,33.2685,442410,171947,899535,1169998,2683890,3387,1586,366,224,5563
231,2013-12-04,33.1815,412355,193308,880051,1099098,2584812,2970,1774,311,254,5309
232,2013-12-05,32.9855,442386,210328,914383,1146441,2713538,2855,1924,302,250,5331
233,2013-12-06,32.7,423420,179959,923299,1166760,2693438,2938,1715,312,250,5215
234,2013-12-09,32.7525,443684,197400,938092,1184376,2763552,2978,1686,305,268,5237
235,2013-12-10,32.7005,470163,167788,930624,1232999,2801574,3184,1553,319,251,5307
236,2013-12-11,32.778,474818,151118,962729,1286429,2875094,3398,1381,355,234,5368
237,2013-12-12,32.7915,517179,138943,948580,1326816,2931518,3486,1257,369,224,5336
238,2013-12-13,32.8505,541767,128662,938243,1351348,2960020,3683,992,378,199,5252
239,2013-12-16,32.9025,390268,124875,665977,931370,2112490,2417,875,272,141,3705
240,2013-12-17,32.9695,381713,134906,665150,911957,2093726,2622,1097,286,177,4182
241,2013-12-18,32.814,294949,172413,769154,891690,2128206,2578,1166,282,177,4203
242,2013-12-19,32.99,340139,150464,725340,915015,2130958,2531,1238,264,201,4234
243,2013-12-20,32.98,342730,142981,690430,890179,2066320,2598,1216,286,184,4284
244,2013-12-23,32.661,324785,185478,777738,917045,2205046,2644,1445,265,206,4560
245,2013-12-24,32.64,375649,162385,788662,1001926,2328622,2850,1398,288,211,4747
246,2013-12-25,32.6905,466519,138749,748946,1076716,2430930,2984,1152,309,182,4627
247,2013-12-26,32.6665,356719,145004,829771,1041486,2372980,2909,1212,301,191,4613
248,2013-12-27,32.5945,389796,142280,819997,1067513,2419586,2938,1252,281,201,4672
249,2013-12-30,32.835,388735,115114,818410,1092031,2414290,3041,837,314,166,4358
250,2014-01-06,33.2125,326022,129856,826366,1022532,2304776,2715,1070,293,154,4232
251,2014-01-08,33.1935,343352,132884,824260,1034728,2335224,2713,1035,285,172,4205
252,2014-01-09,33.234,351995,150728,815103,1016370,2334196,2781,1268,304,179,4532
253,2014-01-10,33.027,356524,153187,830513,1033850,2374074,2705,1311,288,220,4524
254,2014-01-13,33.2825,344983,171755,868372,1041600,2426710,2661,1490,304,209,4664
255,2014-01-14,33.302,380104,181929,886390,1084565,2532988,3042,1499,329,216,5086
256,2014-01-15,33.4,350081,249511,904306,1004876,2508774,2936,1771,324,228,5259
257,2014-01-16,33.4125,346179,269373,880532,957338,2453422,2813,1868,314,244,5239
258,2014-01-17,33.5905,345485,304261,869345,910569,2429660,2780,2105,298,268,5451
259,2014-01-20,33.768,367680,382275,888797,874202,2512954,2753,2449,300,271,5773
260,2014-01-21,33.935,334363,442664,918319,810018,2505364,2666,2787,303,289,6045
261,2014-01-22,33.9305,330039,431410,908596,807225,2477270,2587,2725,307,297,5916
262,2014-01-23,34.115,324364,503552,994212,815024,2637152,2702,2855,313,292,6162
263,2014-01-24,34.527,311177,460168,981582,832591,2585518,2501,3151,294,343,6289
264,2014-01-27,34.69,323823,508926,1040957,855854,2729560,2569,3138,294,347,6348
265,2014-01-28,34.742,307318,530930,1123623,900011,2861882,2512,3293,291,357,6453
266,2014-01-29,35.1305,339233,602183,1333135,1070185,3344736,2418,3798,270,393,6879
267,2014-01-30,34.905,373778,530473,1335530,1178835,3418616,2521,3246,289,377,6433
268,2014-01-31,35.196,345649,535291,1271668,1082026,3234634,2445,3504,282,388,6619
269,2014-02-03,35.44,297289,538537,1427120,1185872,3448818,2380,3509,284,401,6574
270,2014-02-04,35.003,298209,560076,1509986,1248119,3616390,2450,3588,266,418,6722
271,2014-02-05,34.898,303922,502350,1434380,1235952,3476604,2360,3632,261,439,6692
272,2014-02-06,34.694,288131,484746,1393510,1196895,3363282,2380,3561,269,451,6661
273,2014-02-07,34.7685,263184,461455,1334634,1136363,3195636,2376,3334,269,440,6419
274,2014-02-10,34.76,291828,472802,1212036,1031062,3007728,2689,3170,293,412,6564
275,2014-02-11,34.7525,312376,477978,1219152,1053550,3063056,2825,3077,295,396,6593
276,2014-02-12,34.831,372459,471661,1198839,1099637,3142596,3001,2943,312,409,6665
277,2014-02-13,35.1495,410967,504168,1213046,1119845,3248026,3222,3060,347,370,6999
278,2014-02-14,35.08,369508,483294,1269632,1155846,3278280,3065,2797,347,351,6560
279,2014-02-17,35.2195,350814,495895,1299720,1154639,3301068,3003,2971,350,356,6680
280,2014-02-18,35.4115,357244,554107,1326944,1130081,3368376,3044,2970,335,372,6721
281,2014-02-19,35.795,385334,549744,1347836,1183426,3466340,2942,3489,331,406,7168
282,2014-02-20,35.775,409533,488884,1215677,1136326,3250420,3062,3306,327,392,7087
283,2014-02-21,35.489,360460,507475,1275182,1128167,3271284,2960,3261,303,413,6937
284,2014-02-24,35.483,341768,513813,1296373,1124328,3276282,2587,3570,302,432,6891
285,2014-02-25,35.705,382010,492896,1243342,1132456,3250704,2799,3377,326,402,6904
286,2014-02-26,36.0195,371571,522952,1306438,1155057,3356018,2946,3699,313,447,7405
287,2014-02-27,36.036,412829,483531,1249862,1179160,3325382,3019,3444,330,429,7222
288,2014-02-28,35.886,363767,453772,1241593,1151588,3210720,2763,3299,306,421,6789
289,2014-03-03,36.51,470954,275060,1148298,1344192,3238504,3229,2367,365,302,6263
290,2014-03-04,36.065,402868,268396,1170199,1304671,3146134,3078,2493,373,340,6284
291,2014-03-05,36.0435,385900,331604,1210434,1264730,3192668,3188,2525,392,345,6450
292,2014-03-06,36.1365,420646,328168,1154916,1247394,3151124,3473,2307,427,286,6493
293,2014-03-07,36.4695,402272,313521,1101527,1190278,3007598,3376,2376,417,281,6450
294,2014-03-11,36.5,409231,308291,1093249,1194189,3004960,3396,2415,434,292,6537
295,2014-03-12,36.5,423110,300030,1104061,1227141,3054342,3380,2440,426,304,6550
296,2014-03-13,36.6085,447617,273776,982058,1155899,2859350,3177,2283,422,289,6171
297,2014-03-14,36.597,441471,207548,1058350,1292273,2999642,3099,1925,410,236,5670
298,2014-03-17,36.33,308120,235358,930499,1003261,2477238,2078,1764,254,250,4346
299,2014-03-18,36.2205,319793,254785,966169,1031177,2571924,2117,2162,282,286,4847
300,2014-03-19,36.136,328372,219385,1011512,1120499,2679768,2501,1984,305,265,5055
301,2014-03-20,36.38,318268,189137,1009062,1138193,2654660,2344,1983,297,262,4886
302,2014-03-21,36.2595,343401,166286,1000165,1177280,2687132,2593,1825,323,244,4985
303,2014-03-24,36.052,356196,198927,981516,1138785,2675424,2625,1960,324,245,5154
304,2014-03-25,35.56,404925,183874,1032347,1253398,2874544,2745,1857,328,251,5181
305,2014-03-26,35.53,394049,162428,1076888,1308509,2941874,3006,1822,353,270,5451
306,2014-03-27,35.5905,397911,136548,890773,1152136,2577368,3265,1557,406,225,5453
307,2014-03-28,35.78,390337,150929,906564,1145972,2593802,3177,1523,403,235,5338
308,2014-03-31,35.12,389189,157723,1061089,1292555,2900556,2734,1749,363,260,5106
309,2014-04-01,35.0995,429893,134039,1119317,1415171,3098420,3004,1656,390,245,5295
310,2014-04-02,35.418,434800,138107,1135793,1432486,3141186,3181,1418,429,221,5249
311,2014-04-03,35.5,459619,117892,1092067,1433794,3103372,3466,1144,449,215,5274
312,2014-04-04,35.3,421552,154132,1112334,1379754,3067772,3058,1620,364,280,5322
313,2014-04-07,35.642,518881,105596,1067587,1480872,3172936,3372,1111,453,199,5135
314,2014-04-08,35.6805,559191,117563,1072547,1514175,3263476,3275,1193,453,197,5118
315,2014-04-09,35.642,524275,125281,959976,1358970,2968502,3144,1309,438,214,5105
316,2014-04-10,35.57,482132,144114,860041,1198059,2684346,2981,1619,391,259,5250
317,2014-04-11,35.645,521909,109205,810765,1223469,2665348,3223,1206,425,221,5075
318,2014-04-14,35.9845,491055,123982,806282,1173355,2594674,2998,1286,388,227,4899
319,2014-04-15,36.1925,495695,130514,870018,1235199,2731426,3149,1450,424,207,5230
320,2014-04-16,35.9885,455115,150629,904097,1208583,2718424,2882,1556,396,258,5092
321,2014-04-17,35.46,458238,161665,957318,1253891,2831112,2645,1808,374,271,5098
322,2014-04-18,35.6105,452438,147003,953005,1258440,2810886,2699,1649,366,271,4985
323,2014-04-21,35.7265,458861,137878,926593,1247576,2770908,2846,1590,429,222,5087
324,2014-04-22,35.699,467727,158253,977803,1287277,2891060,2683,1693,423,248,5047
325,2014-04-23,35.6755,470452,136386,968250,1302316,2877404,2814,1718,432,257,5221
326,2014-04-24,35.772,511326,109450,1068616,1470492,3159884,3366,1228,487,210,5291
327,2014-04-25,36.0285,504883,122688,1049075,1431270,3107916,3249,1263,462,214,5188
328,2014-04-28,35.821,465953,128905,1108985,1446033,3149876,2816,1474,414,252,4956
329,2014-04-29,35.602,431677,161705,1147874,1417846,3159102,2673,1770,379,282,5104
330,2014-04-30,35.63,424462,151283,1185020,1458199,3218964,2702,1661,394,261,5018
331,2014-05-02,35.8735,439019,124704,1157192,1471507,3192422,2779,1379,426,215,4799
332,2014-05-05,35.7195,453018,137609,1142283,1457692,3190602,2730,1578,406,260,4974
333,2014-05-06,35.41,479217,164367,1147020,1461870,3252474,2734,1908,402,275,5319
334,2014-05-07,34.9295,511554,162271,1126728,1476011,3276564,2917,1708,417,261,5303
335,2014-05-08,35.04,511067,137445,1115347,1488969,3252828,3027,1416,406,250,5099
336,2014-05-12,35.0425,511937,152465,1087195,1446667,3198264,2933,1491,410,277,5111
337,2014-05-13,34.8525,579770,149194,1106413,1536989,3372366,3134,1715,426,285,5560
338,2014-05-14,34.72,596788,154177,1101323,1543934,3396222,3251,1677,432,276,5636
339,2014-05-15,34.75,604694,127069,1139722,1617347,3488832,3740,1318,481,245,5784
340,2014-05-16,34.77,595005,141477,1142341,1595869,3474692,3737,1324,481,248,5790
341,2014-05-19,34.5655,541706,150174,1077954,1469486,3239320,3508,1673,446,281,5908
342,2014-05-20,34.5215,497390,153758,1093677,1437309,3182134,3709,1566,475,295,6045
343,2014-05-21,34.345,526546,166472,1084662,1444736,3222416,3700,1622,458,263,6043
344,2014-05-22,34.3195,524747,142828,1114714,1496633,3278922,3945,1525,539,258,6267
345,2014-05-23,34.17,553703,140797,1107851,1520757,3323108,4107,1465,519,248,6339
346,2014-05-26,34.2035,584052,119280,1092608,1557380,3353320,4326,1400,538,254,6518
347,2014-05-27,34.406,689341,94790,1125358,1719909,3629398,5227,789,650,171,6837
348,2014-05-28,34.5615,683124,82231,1177702,1778595,3721652,5213,790,661,186,6850
349,2014-05-29,34.658,599378,91011,1174736,1683103,3548228,4676,914,606,203,6399
350,2014-05-30,34.8945,604042,94782,1177011,1686271,3562106,4592,869,587,207,6255
351,2014-06-02,34.93,510759,118965,1204450,1596244,3430418,4074,1112,533,230,5949
352,2014-06-03,35.0695,513667,114837,1274104,1672934,3575542,4174,1071,519,232,5996
353,2014-06-04,34.9995,492513,122197,1298834,1669150,3582694,3737,1268,482,248,5735
354,2014-06-05,34.7415,434083,170929,1306534,1569688,3481234,3131,1998,420,334,5883
355,2014-06-06,34.418,457782,165957,1415379,1707204,3746322,3411,1774,433,309,5927
356,2014-06-09,34.34,471542,161891,1476208,1785859,3895500,3674,1662,465,292,6093
357,2014-06-10,34.365,484950,153594,1465854,1797210,3901608,3847,1565,489,266,6167
358,2014-06-11,34.379,492090,143806,1449534,1797818,3883248,3849,1374,487,269,5979
359,2014-06-13,34.452,501283,127358,1426745,1800670,3856056,3851,1214,511,229,5805
360,2014-06-16,34.6385,461995,84412,925642,1303225,2775274,3017,624,403,142,4186
361,2014-06-17,34.8265,521319,107697,1002286,1415908,3047210,3920,762,451,172,5305
362,2014-06-18,34.42,511409,142134,1069968,1439243,3162754,3603,1346,384,257,5590
363,2014-06-19,34.396,480228,157651,1116647,1439224,3193750,3625,1558,403,272,5858
364,2014-06-20,34.479,508371,136163,1141677,1513885,3300096,3771,1334,437,236,5778
365,2014-06-23,34.127,522177,147202,1159115,1534090,3362584,3659,1646,410,265,5980
366,2014-06-24,33.8175,581774,156098,1097272,1522948,3358092,3913,1736,414,293,6356
367,2014-06-25,33.7455,573923,138931,1152115,1587107,3452076,4180,1422,449,258,6309
368,2014-06-26,33.72,619808,131072,1141107,1629843,3521830,4332,1492,485,255,6564
369,2014-06-27,33.738,639899,124464,1189215,1704650,3658228,4449,1348,502,252,6551
370,2014-06-30,33.9825,714016,80159,1235610,1869467,3899252,5233,756,591,178,6758
371,2014-07-01,34.34,648821,96052,1301735,1854504,3901112,4859,844,580,200,6483
372,2014-07-02,34.281,550205,125477,1399621,1824349,3899652,4254,1141,492,231,6118
373,2014-07-03,34.284,562571,120835,1531068,1972804,4187278,4257,1068,494,243,6062
374,2014-07-04,34.42,594066,106675,1554375,2041766,4296882,4480,915,542,202,6139
375,2014-07-07,34.455,542120,130016,1556495,1968599,4197230,4078,1243,484,249,6054
376,2014-07-08,34.23,440088,183125,1541228,1798191,3962632,3420,2001,432,312,6165
377,2014-07-09,33.9125,451775,212108,1525245,1764912,3954040,3394,2222,425,350,6391
378,2014-07-10,33.95,600111,130327,1583927,2053711,4368076,4090,1440,489,244,6263
379,2014-07-11,34.2055,624554,137822,1621608,2108340,4492324,4256,1346,515,233,6350
380,2014-07-14,34.3275,676602,124525,1683216,2235293,4719636,4812,857,561,189,6419
381,2014-07-15,34.3945,646711,144439,1659402,2161674,4612226,4515,1063,530,217,6325
382,2014-07-16,34.3875,624772,150469,1677445,2151748,4604434,4412,1134,512,223,6281
383,2014-07-17,35.182,611467,172445,1664200,2103222,4551334,4195,1376,491,251,6313
384,2014-07-18,35.1425,529739,192861,1716754,2053632,4492986,4078,1389,478,235,6180
385,2014-07-21,35.19,587104,177617,1689931,2099418,4554070,4371,1315,511,221,6418
386,2014-07-22,34.996,425640,279318,1808658,1954980,4468596,3205,2373,402,311,6291
387,2014-07-23,34.8995,428745,258073,1809913,1980585,4477316,3297,2331,388,323,6339
388,2014-07-24,35.0435,525045,224267,1811761,2112539,4673612,3809,1722,461,265,6257
389,2014-07-25,35.13,531319,213219,1851312,2169412,4765262,3760,1721,457,252,6190
390,2014-07-28,35.5425,500123,177455,1901544,2224212,4803334,4334,1379,501,212,6426
391,2014-07-29,35.8045,458356,191646,1948730,2215440,4814172,4047,1568,506,213,6334
392,2014-07-30,35.586,335548,243985,2110929,2202492,4892954,3554,1793,416,255,6018
393,2014-07-31,35.7485,358025,231841,2080163,2206347,4876376,3762,1678,459,227,6126
394,2014-08-01,35.7495,363747,240571,2028143,2151319,4783780,3834,1609,458,252,6153
395,2014-08-04,35.783,339241,258710,2048532,2129063,4775546,3813,1800,500,239,6352
396,2014-08-05,36.0785,380511,260703,2036550,2156358,4834122,3904,1775,509,242,6430
397,2014-08-06,36.189,361422,237489,1934236,2058169,4591316,3688,1936,461,288,6373
398,2014-08-07,36.27,331466,213183,1926372,2044655,4515676,3427,2050,439,288,6204
399,2014-08-08,36.1205,306506,236338,1950818,2020986,4514648,3145,2283,414,309,6151
400,2014-08-11,35.929,238025,298656,2059150,1998519,4594350,2433,3197,308,414,6352
401,2014-08-12,36.18,282515,281300,1981120,1982335,4527270,2913,2855,394,351,6513
402,2014-08-13,36.0005,239153,328838,2033115,1943430,4544536,2598,3100,328,421,6447
403,2014-08-14,36.036,223178,292560,2057970,1988588,4562296,2386,3288,304,413,6391
404,2014-08-15,36.131,229534,273249,2049129,2005414,4557326,2525,2944,330,390,6189
405,2014-08-18,36.0595,253728,245337,1996325,2004716,4500106,2748,2686,392,335,6161
406,2014-08-19,36.185,320934,226906,1947532,2041560,4536932,3134,2468,407,334,6343
407,2014-08-20,36.3005,381321,233388,1950176,2098109,4662994,3383,2412,444,308,6547
408,2014-08-21,36.024,308324,246439,1972843,2034728,4562334,3488,2263,399,351,6501
409,2014-08-22,36.11,312338,241134,1963902,2035106,4552480,2908,2565,392,362,6227
410,2014-08-25,36.095,310079,255224,1957708,2012563,4535574,2957,2686,390,379,6412
411,2014-08-26,36.1005,303272,259523,2094632,2138381,4795808,2821,2875,390,373,6459
412,2014-08-27,36.172,295493,256839,2233699,2272353,5058384,2807,2792,387,354,6340
413,2014-08-28,36.75,351185,262406,2391785,2480564,5485940,3567,2328,449,288,6632
414,2014-08-29,37.1235,327557,291686,2350501,2386372,5356116,3443,2564,475,280,6762
415,2014-09-01,37.302,326471,297989,2308771,2337253,5270484,3243,2817,441,298,6799
416,2014-09-02,37.4625,328862,328272,2311810,2312400,5281344,3166,3164,432,331,7093
417,2014-09-03,36.863,205863,304272,2377383,2278974,5166492,2105,3467,334,382,6288
418,2014-09-04,37.0075,213582,333308,2413370,2293644,5253904,2216,3377,383,364,6340
419,2014-09-05,36.92,178780,356522,2384162,2206420,5125884,1949,3595,292,425,6261
420,2014-09-08,37.0695,235273,321329,2264185,2178129,4998916,2467,3124,364,348,6303
421,2014-09-09,37.1115,239240,329100,2216996,2127136,4912472,2654,3150,370,351,6525
422,2014-09-10,37.29,360265,309790,2172995,2223470,5066520,3479,2700,452,321,6952
423,2014-09-11,37.5095,313111,296838,2070676,2086949,4767574,3345,2899,437,320,7001
424,2014-09-12,37.785,261350,333578,1971716,1899488,4466132,3065,3159,398,354,6976
425,2014-09-15,38.385,242392,369660,1608037,1480769,3700858,2455,2871,314,272,5912
426,2014-09-16,38.33,220837,479110,1715334,1457061,3872342,2447,3698,298,357,6800
427,2014-09-17,38.419,155995,456357,1746230,1445868,3804450,2291,3731,267,427,6716
428,2014-09-18,38.478,203685,414807,1711123,1500001,3829616,2713,3495,318,384,6910
429,2014-09-19,38.4215,202750,404112,1689200,1487838,3783900,2707,3387,326,373,6793
430,2014-09-22,38.6995,264445,379990,1618693,1503148,3766276,3107,3308,414,327,7156
431,2014-09-23,38.616,214989,457552,1780707,1538144,3991392,2635,3810,347,426,7218
432,2014-09-24,38.15,141385,485993,1898282,1553674,4079334,1732,4783,223,500,7238
433,2014-09-25,38.4915,203239,465929,1856050,1593360,4118578,2155,4438,289,441,7323
434,2014-09-26,39.1765,255041,504528,1877963,1628476,4266008,2989,3842,379,360,7570
435,2014-09-29,39.4395,265544,525524,1926099,1666119,4383286,2831,4156,373,390,7750
436,2014-09-30,39.5925,234218,521017,1925445,1638646,4319326,2838,4159,367,381,7745
437,2014-10-01,39.7,223053,537064,2033864,1719853,4513834,2649,4395,336,422,7802
438,2014-10-02,39.561,234817,563094,1988715,1660438,4447064,2692,4418,378,415,7903
439,2014-10-03,39.957,263425,539137,1951365,1675653,4429580,3023,4323,390,412,8148
440,2014-10-06,39.73,237244,559137,1947430,1625537,4369348,2565,4686,312,493,8056
441,2014-10-07,39.904,256054,535601,1921313,1641766,4354734,2981,4279,361,423,8044
442,2014-10-08,40.0,261827,524776,1935724,1672775,4395102,3291,4149,424,385,8249
443,2014-10-09,40.1475,246892,524056,1911533,1634369,4316850,2976,4216,350,417,7959
444,2014-10-10,40.325,269319,506778,1770945,1533486,4080528,3031,4238,376,384,8029
445,2014-10-13,40.4925,271313,555913,1846382,1561782,4235390,3239,4212,372,390,8213
446,2014-10-14,40.92,343829,506122,1805327,1643034,4298312,3389,4121,387,380,8277
447,2014-10-15,40.4505,307360,463679,1714948,1558629,4044616,2942,4311,323,462,8038
448,2014-10-16,40.869,275293,466106,1767111,1576298,4084808,3265,4132,379,409,8185
449,2014-10-17,40.7525,200078,504943,1885192,1580327,4170540,2792,4319,303,469,7883
450,2014-10-20,41.0375,248416,487941,1886110,1646585,4269052,3316,4169,392,430,8307
451,2014-10-21,40.964,192335,535600,1928426,1585161,4241522,2899,4586,301,499,8285
452,2014-10-22,41.4195,293024,488408,1785932,1590548,4157912,3392,4266,433,391,8482
453,2014-10-23,41.715,321749,438754,1707587,1590582,4058672,3535,4066,438,381,8420
454,2014-10-24,41.906,343033,454354,1774827,1663506,4235720,3495,4173,412,422,8502
455,2014-10-27,42.28,343715,468232,1816332,1691815,4320094,3565,4037,397,420,8419
456,2014-10-28,42.468,398146,433085,1805511,1770572,4407314,3763,3944,440,415,8562
457,2014-10-29,43.2,383430,452442,1876271,1807259,4519402,3867,4106,449,398,8820
458,2014-10-30,41.6445,225796,322092,1922536,1826240,4296664,2458,4464,275,468,7665
459,2014-10-31,43.034,234964,373995,1993470,1854439,4456868,2460,4572,310,458,7800
460,2014-11-03,43.608,279706,343736,1945544,1881514,4450500,2709,4457,329,448,7943
461,2014-11-05,44.95,307508,308319,1766961,1766150,4148938,3338,3494,405,365,7602
462,2014-11-06,46.8675,331329,272886,1692044,1750487,4046746,3588,3408,411,348,7755
463,2014-11-07,46.65,262665,259582,1840301,1843384,4205932,3185,3034,379,342,6940
464,2014-11-10,45.8525,187327,254388,1950201,1883140,4275056,3011,3246,343,412,7012
465,2014-11-11,46.3515,228822,238454,2006000,1996368,4469644,3442,3035,398,400,7275
466,2014-11-12,45.9615,198548,286178,1982344,1894714,4361784,2995,3566,328,449,7338
467,2014-11-13,46.82,244822,232646,1908162,1920338,4305968,3617,2888,434,352,7291
468,2014-11-14,47.1735,236491,252753,2032978,2016716,4538938,3488,3092,443,333,7356
469,2014-11-17,47.1045,213810,250896,1949768,1912682,4327156,3414,3217,427,347,7405
470,2014-11-18,46.9025,205723,299013,1877604,1784314,4166654,3186,3656,417,381,7640
471,2014-11-19,46.861,202243,309922,1883914,1776235,4172314,2979,3935,376,396,7686
472,2014-11-20,46.152,162455,377989,1849464,1633930,4023838,2173,5230,270,568,8241
473,2014-11-21,45.714,168446,356956,2035125,1846615,4407142,2190,4757,274,526,7747
474,2014-11-24,44.997,178719,330516,1835692,1683895,4028822,2397,4760,292,539,7988
475,2014-11-25,46.263,249595,304178,1894531,1839948,4288252,3187,4123,387,471,8168
476,2014-11-26,47.388,335629,254672,1877758,1958715,4426774,4570,3051,522,345,8488
477,2014-11-27,48.655,336306,267075,1868647,1937878,4409906,4422,3129,495,347,8393
478,2014-11-28,50.4085,294387,222756,2053241,2124872,4695256,4106,3139,471,337,8053
479,2014-12-01,51.22,253786,195804,2202913,2260895,4913398,3587,3177,418,349,7531
480,2014-12-02,53.85,278833,197343,2123013,2204503,4803692,3766,3304,442,370,7882
481,2014-12-03,53.1905,182020,203013,2174993,2154000,4714026,3380,3527,382,415,7704
482,2014-12-04,54.29,241417,190312,2063675,2114780,4610184,3911,3358,473,358,8100
483,2014-12-05,52.51,235694,168369,2101481,2168806,4674350,3813,3338,434,378,7963
484,2014-12-08,53.745,206749,180024,1966062,1992787,4345622,3903,3152,450,380,7885
485,2014-12-09,54.049,212060,187299,1818109,1842870,4060338,3933,3225,498,378,8034
486,2014-12-10,54.85,253037,210024,1800434,1843447,4106942,4496,3229,524,346,8595
487,2014-12-11,56.44,271171,246657,1957678,1982192,4457698,4372,3528,520,352,8772
488,2014-12-12,58.18,299833,175362,1945093,2069564,4489852,4442,3066,522,341,8371
489,2014-12-15,64.4455,259345,122761,1446323,1582907,3411336,3906,2334,431,235,6906
490,2014-12-16,67.5,146411,58809,1386362,1473964,3065546,3216,1506,370,202,5294
491,2014-12-17,60.2205,111929,60113,1392359,1444175,3008576,2966,1716,276,264,5222
492,2014-12-18,61.5,134929,68544,1273271,1339656,2816400,3255,1798,325,238,5616
493,2014-12-19,58.55,136260,71368,1325723,1390615,2923966,3513,1813,336,225,5887
494,2014-12-22,55.8,131255,69098,1321420,1383577,2905350,2927,2187,325,237,5676
495,2014-12-23,54.5035,139345,59013,1124189,1204521,2527068,3311,2157,375,190,6033
496,2014-12-24,53.44,142943,67248,1157618,1233313,2601122,3347,2270,354,214,6185
497,2014-12-25,52.5515,136054,65651,1159703,1230106,2591514,3143,2565,327,266,6301
498,2014-12-26,54.004,160805,44669,1113619,1229755,2548848,3714,2031,360,216,6321
499,2014-12-29,58.322,202333,34760,1110170,1277743,2625006,5157,1319,443,154,7073
500,2014-12-29,58.322,202333,34760,1110170,1277743,2625006,5157,1319,443,154,7073
501,2014-12-30,56.0,223423,21347,1193308,1395384,2833462,5024,992,410,142,6568
502,2015-01-05,60.85,211036,20788,1179149,1369397,2780370,5326,1046,467,145,6984
503,2015-01-06,63.24,198531,30293,1185831,1354069,2768724,4936,1286,434,150,6806
504,2015-01-08,60.301,197002,40336,1202245,1358911,2798494,4393,1847,380,193,6813
505,2015-01-09,61.55,230785,36659,1213401,1407527,2888372,4847,1448,412,189,6896
506,2015-01-12,63.17,256968,41442,1224307,1439833,2962550,5656,1499,489,167,7811
507,2015-01-13,65.25,273652,45464,1252796,1480984,3052896,5578,1644,476,181,7879
508,2015-01-14,64.773,256384,52635,1215722,1419471,2944212,5286,1943,447,217,7893
509,2015-01-15,65.29,245224,69605,1218966,1394585,2928380,4440,2600,391,265,7696
510,2015-01-16,65.1985,238663,63580,1229359,1404442,2936044,4781,2269,424,247,7721
511,2015-01-19,65.02,217635,83335,1238034,1372334,2911338,4484,2692,404,253,7833
512,2015-01-20,65.2,254616,56101,1329069,1527584,3167370,5675,2028,486,210,8399
513,2015-01-21,65.35,236286,80119,1446655,1602822,3365882,4796,2619,410,271,8096
514,2015-01-22,64.12,225392,119962,1400211,1505641,3251206,3244,4392,345,358,8339
515,2015-01-23,64.2395,206585,104069,1410813,1513329,3234796,3263,4091,389,333,8076
516,2015-01-26,68.799,264814,71413,1327959,1521360,3185546,5046,2790,516,260,8612
517,2015-01-27,66.82,269593,71386,1268345,1466552,3075876,5523,2118,493,244,8378
518,2015-01-28,68.0345,272456,68806,1408747,1612397,3362406,5804,1906,542,205,8457
519,2015-01-29,68.73,281974,66049,1474262,1690187,3512472,5799,2017,523,212,8551
520,2015-01-30,68.9105,273475,72361,1498050,1699164,3543050,5796,2128,532,208,8664
521,2015-02-02,68.42,217693,110837,1452612,1559468,3340610,4706,3119,427,329,8581
522,2015-02-03,65.168,199505,128343,1221153,1292315,2841316,3446,4381,334,400,8561
523,2015-02-04,67.993,242120,93046,1310501,1459575,3105242,4682,3233,460,301,8676
524,2015-02-05,66.6,216805,129344,1306657,1394118,3046924,3563,4035,351,371,8320
525,2015-02-06,66.985,242721,108897,1250914,1384738,2987270,4304,3382,414,306,8406
526,2015-02-09,65.86,218504,124929,1185337,1278912,2807682,3483,4263,329,381,8456
527,2015-02-10,65.455,259017,106724,1095583,1247876,2709200,4619,3350,441,285,8695
528,2015-02-11,65.25,238858,99324,1232527,1372061,2942770,4492,3354,398,303,8547
529,2015-02-12,65.27,206460,125458,1187279,1268281,2787478,3466,3906,336,344,8052
530,2015-02-13,63.5,195422,149559,1203856,1249719,2798556,3127,4643,342,374,8486
531,2015-02-16,63.184,181257,125567,1098303,1153993,2559120,3553,4233,384,323,8493
532,2015-02-17,62.505,216514,110626,1017274,1123162,2467576,3887,3975,402,311,8575
533,2015-02-18,61.582,167245,153461,1067662,1081446,2469814,3324,4607,355,396,8682
534,2015-02-19,61.9,209902,114096,1073168,1168974,2566140,4604,3591,458,290,8943
535,2015-02-20,62.05,186855,119515,1269216,1336556,2912142,3834,3884,419,328,8465
536,2015-02-24,62.853,249744,94191,1100359,1255912,2700206,5908,2166,489,256,8819
537,2015-02-25,61.389,247707,113016,1254500,1389191,3004414,5646,2573,486,282,8987
538,2015-02-26,61.15,201239,132330,1261466,1330375,2925410,3938,4412,428,366,9144
539,2015-02-27,61.6,222473,107069,1285775,1401179,3016496,4233,3829,459,311,8832
540,2015-03-02,62.65,222058,107601,1199398,1313855,2842912,4337,3765,462,320,8884
541,2015-03-03,61.887,227993,115228,1074169,1186934,2604324,5258,2766,477,292,8793
542,2015-03-04,61.945,255496,93154,1073056,1235398,2657104,5898,2286,530,257,8971
543,2015-03-05,60.821,218865,173542,1115283,1160606,2668296,3704,4659,411,367,9141
544,2015-03-06,60.445,193678,143950,1127808,1177536,2642972,4062,4050,477,305,8894
545,2015-03-10,62.53,245248,117056,1108767,1236959,2708030,4875,3382,521,258,9036
546,2015-03-11,61.617,226513,95850,1174352,1305015,2801730,5530,2175,473,264,8442
547,2015-03-12,61.19,213229,102573,1118477,1229133,2663412,5618,2430,452,270,8770
548,2015-03-13,62.249,220249,81808,1392814,1531255,3226126,5832,1984,455,192,8463
549,2015-03-16,62.192,220597,47205,950371,1123763,2341936,3739,1302,390,156,5587
550,2015-03-17,61.45,189343,80639,935717,1044421,2250120,3226,2190,331,252,5999
551,2015-03-18,59.335,188891,86644,1015269,1117516,2408320,3210,2568,318,301,6397
552,2015-03-19,59.994,166539,129855,1022032,1058716,2377142,2786,4425,322,302,7835
553,2015-03-20,59.255,170927,126428,1036333,1080832,2414520,2909,4137,322,261,7629
554,2015-03-23,58.741,166304,144691,998041,1019654,2328690,2843,4587,327,279,8036
555,2015-03-24,57.69,184209,128899,919774,975084,2207966,3267,4206,387,243,8103
556,2015-03-25,57.45,209738,103862,915966,1021842,2251408,3903,3699,392,214,8208
557,2015-03-26,57.291,218874,102451,928165,1044588,2294078,4027,3753,387,212,8379
558,2015-03-27,57.9,218357,95334,888743,1011766,2214200,4390,3400,411,197,8398
559,2015-03-30,57.61,245747,87241,870117,1028623,2231728,5988,1986,412,243,8629
560,2015-03-31,58.205,263136,63418,852668,1052386,2231608,6318,1742,447,172,8679
561,2015-04-01,57.61,233377,113881,961127,1080623,2389008,5503,2727,381,249,8860
562,2015-04-02,56.65,224464,144925,990720,1070259,2430368,3878,4439,376,246,8939
563,2015-04-03,56.606,236597,115039,974288,1095846,2421770,4065,3909,407,235,8616
564,2015-04-06,55.488,219524,164046,934220,989698,2307488,3750,4726,366,288,9130
565,2015-04-07,55.026,215402,167047,897774,946129,2226352,3737,4843,377,277,9234
566,2015-04-08,53.637,241699,144899,951643,1048443,2386684,4527,4303,398,243,9471
567,2015-04-09,51.862,240657,146695,938021,1031983,2357356,4489,4305,420,239,9453
568,2015-04-10,53.6,260140,106978,925019,1078181,2370318,5273,3616,484,166,9539
569,2015-04-13,52.03,258866,109055,958457,1108268,2434646,5493,3408,469,188,9558
570,2015-04-14,50.897,237294,175135,1085014,1147173,2644616,4827,4703,426,252,10208
571,2015-04-15,49.7,208624,185294,1115974,1139304,2649196,4594,5143,411,285,10433
572,2015-04-16,49.8,257150,123045,1073344,1207449,2660988,5655,3979,471,184,10289
573,2015-04-17,51.895,313892,71737,1016667,1258822,2661118,7664,1554,518,152,9888
574,2015-04-20,53.335,311851,61531,991808,1242128,2607318,7893,1408,496,179,9976
575,2015-04-21,53.8,286207,79253,987302,1194256,2547018,7423,1840,450,229,9942
576,2015-04-22,52.18,258824,141151,1097286,1214959,2712220,6750,2915,443,243,10351
577,2015-04-23,50.78,230157,180967,1137815,1187005,2735944,4908,4916,431,275,10530
578,2015-04-24,50.9,318870,87147,1073137,1304860,2784014,6252,3610,503,207,10572
579,2015-04-27,51.978,378400,75941,1072619,1375078,2902038,7246,3082,536,175,11039
580,2015-04-28,51.546,342053,121951,1055211,1275313,2794528,8151,2272,499,227,11149
581,2015-04-29,51.055,305807,144025,1068993,1230775,2749600,7671,2947,490,237,11345
582,2015-04-30,51.69,331112,72630,1108906,1367388,2880036,8158,1464,510,190,10322
583,2015-05-05,50.496,255970,194326,1209838,1271482,2931616,5417,4661,432,279,10789
584,2015-05-06,50.998,296522,144614,1187030,1338938,2967104,6257,3922,488,210,10877
585,2015-05-07,50.29,286426,163932,1320255,1442749,3213362,6132,4269,466,248,11115
586,2015-05-08,51.04,311842,118182,1264319,1457979,3152322,6507,3452,515,208,10682
587,2015-05-12,49.958,272081,197224,1315378,1390235,3174918,5875,4764,458,282,11379
588,2015-05-13,49.27,278845,220041,1301948,1360752,3161586,5731,5165,439,297,11632
589,2015-05-14,50.134,329207,155805,1211598,1385000,3081610,6931,3802,524,213,11470
590,2015-05-15,49.57,309932,189086,1213458,1334304,3046780,6235,4608,481,262,11586
591,2015-05-18,49.147,301217,190828,1200125,1310514,3002684,6476,4573,495,250,11794
592,2015-05-19,49.57,383708,127716,1185105,1441097,3137626,7526,3485,564,207,11782
593,2015-05-20,49.701,398820,112212,1205269,1491877,3208178,7489,3316,543,214,11562
594,2015-05-21,49.99,307796,165282,1205098,1347612,3025788,6383,3911,477,247,11018
595,2015-05-22,50.028,375363,121806,1207665,1461222,3166056,6914,3676,504,219,11313
596,2015-05-25,49.965,396651,118786,1205912,1483777,3205126,7437,3379,544,203,11563
597,2015-05-26,50.96,560199,68942,1153659,1644916,3427716,10176,1331,622,156,12285
598,2015-05-27,51.99,551667,71144,1210166,1690689,3523666,9661,1422,580,161,11824
599,2015-05-28,52.6,519847,83788,1225149,1661208,3489992,9219,1622,588,175,11604
600,2015-05-29,52.31,378886,134106,1225292,1470072,3208356,7666,2481,515,224,10886
601,2015-06-01,53.625,499557,95798,1191790,1595549,3382694,9256,1844,580,180,11860
602,2015-06-02,52.78,406188,148666,1119498,1377020,3051372,8204,2548,521,238,11511
603,2015-06-03,54.3,484361,102039,1099820,1482142,3168362,9051,1708,576,189,11524
604,2015-06-04,56.46,465413,115135,1105584,1455862,3141994,8571,2142,559,204,11476
605,2015-06-05,56.245,425086,103587,1156088,1477587,3162348,7936,2010,495,220,10661
606,2015-06-08,55.995,368459,160246,1158546,1366759,3054010,7397,2600,485,224,10706
607,2015-06-09,55.545,328008,206036,1179357,1301329,3014730,6872,3466,456,283,11077
608,2015-06-10,54.331,262663,208713,1274543,1328493,3074412,5260,4780,447,293,10780
609,2015-06-11,54.798,334354,116688,1208832,1426498,3086372,6600,3630,510,201,10941
610,2015-06-15,54.5,227030,165028,960054,1022056,2374168,4562,2475,320,202,7559
611,2015-06-16,53.78,217303,194122,911743,934924,2258092,3921,4920,308,271,9420
612,2015-06-17,53.6,306939,114828,919981,1112092,2453840,5253,3685,402,195,9535
613,2015-06-18,53.47,232304,191613,1049188,1089879,2562984,4311,4920,342,256,9829
614,2015-06-19,54.0,324603,120909,1042567,1246261,2734340,5674,3642,404,213,9933
615,2015-06-22,53.95,319077,139015,974293,1154355,2586740,5116,4173,374,234,9897
616,2015-06-23,53.855,350385,125083,976407,1201709,2653584,5785,3639,398,224,10046
617,2015-06-24,54.446,395268,136111,1010037,1269194,2810610,6186,3652,426,207,10471
618,2015-06-25,54.72,415498,123335,1119596,1411759,3070188,6763,3393,468,196,10820
619,2015-06-26,54.78,484511,97312,1138973,1526172,3246968,8367,1632,470,168,10637
620,2015-06-29,55.715,455794,96506,1146098,1505386,3203784,8425,1562,473,172,10632
621,2015-06-30,55.3,412891,123697,1202504,1491698,3230790,7464,2254,412,207,10337
622,2015-07-01,55.843,430488,109456,1181603,1502635,3224182,8146,1744,448,191,10529
623,2015-07-02,55.53,343390,208416,1177784,1312758,3042348,7112,2941,399,234,10686
624,2015-07-03,56.0,456049,111046,1206138,1551141,3324374,8469,1585,498,169,10721
625,2015-07-06,56.889,513824,121642,1219975,1612157,3467598,8683,1761,502,181,11127
626,2015-07-07,56.739,520204,119259,1256988,1657933,3554384,8525,1851,485,175,11036
627,2015-07-08,57.513,445942,119776,1258868,1585034,3409620,8115,1878,460,176,10629
628,2015-07-09,57.17,348758,196407,1284491,1436842,3266498,7074,2746,394,234,10448
629,2015-07-10,56.429,280257,244386,1338941,1374812,3238396,4778,4925,376,260,10339
630,2015-07-13,56.52,318092,194045,1302777,1426824,3241738,5038,4874,401,239,10552
631,2015-07-14,56.414,264061,258764,1342057,1347354,3212236,4694,5271,364,253,10582
632,2015-07-15,56.938,356572,179917,1334554,1511209,3382252,5467,4770,424,230,10891
633,2015-07-16,56.95,262542,261219,1366985,1368308,3259054,4483,5487,354,281,10605
634,2015-07-17,56.987,354314,171992,1327802,1510124,3364232,5686,4493,421,213,10813
635,2015-07-20,57.0,335480,178887,1308580,1465173,3288120,5057,4782,396,240,10475
636,2015-07-21,56.938,284946,234762,1336761,1386945,3243414,4717,5207,389,266,10579
637,2015-07-22,57.445,368201,163270,1293428,1498359,3323258,5713,4481,435,224,10853
638,2015-07-23,57.851,645640,105126,1290992,1831506,3873264,9045,1968,511,197,11721
639,2015-07-24,58.425,658631,114754,1314790,1858667,3946842,8680,1969,505,196,11350
640,2015-07-27,59.645,644907,108882,1336261,1872286,3962336,8523,1983,485,199,11190
641,2015-07-28,60.02,580259,131997,1444495,1892757,4049508,7724,2418,472,223,10837
642,2015-07-29,58.67,487640,206144,1439166,1720662,3853612,6734,3393,391,274,10792
643,2015-07-30,59.748,528490,127061,1385811,1787240,3828602,7387,2683,433,237,10740
644,2015-07-31,61.72,523895,156730,1406338,1773503,3860466,7370,2652,447,213,10682
645,2015-08-03,63.515,575654,156739,1484680,1903595,4120668,7854,2617,452,231,11154
646,2015-08-04,63.07,487901,201134,1470450,1757217,3916702,7316,2941,432,246,10935
647,2015-08-05,63.461,493051,197140,1488762,1784673,3963626,7011,3090,428,243,10772
648,2015-08-06,64.02,645096,144166,1490595,1991525,4271382,8367,2582,498,238,11685
649,2015-08-07,64.045,562686,157239,1517690,1923137,4160752,7328,2944,435,269,10976
650,2015-08-10,62.81,299246,317223,1686228,1668251,3970948,4326,6255,379,347,11307
651,2015-08-11,64.28,376871,255884,1642219,1763206,4038180,5035,5775,446,286,11542
652,2015-08-12,64.21,362504,248837,1663843,1777510,4052694,6855,3893,429,305,11482
653,2015-08-13,64.705,460366,185392,1447008,1721982,3814748,7664,3388,465,263,11780
654,2015-08-14,64.997,357953,266270,1463734,1555417,3643374,6721,4039,403,312,11475
655,2015-08-17,65.51,441232,195762,1469554,1715024,3821572,7501,3802,458,272,12033
656,2015-08-18,65.881,471515,184267,1500664,1787912,3944358,8214,3222,484,260,12180
657,2015-08-19,66.605,520695,171931,1547999,1896763,4137388,8270,3210,507,257,12244
658,2015-08-20,67.959,503745,164201,1511537,1851081,4030564,7955,3400,488,272,12115
659,2015-08-21,69.108,599742,143748,1453463,1909457,4106410,8992,2711,536,247,12486
660,2015-08-24,70.9,601738,132804,1622600,2091534,4448676,8523,2596,504,265,11888
661,2015-08-25,68.85,459755,213104,1624136,1870787,4167782,7615,3368,432,336,11751
662,2015-08-26,68.901,499818,139112,1611219,1971925,4222074,8042,3034,452,329,11857
663,2015-08-27,66.009,300433,243825,1671906,1728514,3944678,4668,5224,411,359,10662
664,2015-08-28,65.402,269782,228906,1616682,1657558,3772928,4438,5049,389,353,10229
665,2015-08-31,64.249,289937,187713,1538024,1640248,3655922,4624,4800,411,316,10151
666,2015-09-01,66.85,318092,148127,1407078,1577043,3450340,5320,4171,458,287,10236
667,2015-09-02,67.079,411270,132876,1397479,1675873,3617498,8707,2374,501,264,11846
668,2015-09-03,67.2,308288,187952,1403356,1523692,3423288,7059,3468,424,326,11277
669,2015-09-04,68.42,335188,155598,1333342,1512932,3337060,7571,2870,470,269,11180
670,2015-09-07,69.114,425572,163889,1293375,1555058,3437894,8951,2651,529,274,12405
671,2015-09-08,67.99,312306,216042,1532376,1628640,3689364,7218,3841,436,363,11858
672,2015-09-09,68.485,350427,170434,1542961,1722954,3786776,8264,2976,481,310,12031
673,2015-09-10,67.668,345691,212955,1683746,1816482,4058874,7482,3787,444,346,12059
674,2015-09-11,67.924,338798,175459,1623505,1786844,3924606,7615,3206,466,303,11590
675,2015-09-14,67.49,293061,303773,1840190,1829478,4266502,4835,6780,410,376,12401
676,2015-09-15,66.7,177438,249317,1207800,1135921,2770476,3162,6278,286,313,10039
677,2015-09-16,65.33,204509,266780,1220475,1158204,2849968,3360,7094,291,355,11100
678,2015-09-17,65.437,239316,203397,1176580,1212499,2831792,4676,5644,378,274,10972
679,2015-09-18,66.502,228831,207907,1178623,1199547,2814908,4506,5873,361,306,11046
680,2015-09-21,65.988,317140,167622,1157485,1307003,2949250,7337,3005,379,262,10983
681,2015-09-22,66.022,399976,132018,1138929,1406887,3077810,8077,2533,447,227,11284
682,2015-09-23,66.42,273790,220940,1108039,1160889,2763658,4042,6531,363,296,11232
683,2015-09-24,66.099,293136,179148,1107884,1221872,2802040,4595,6116,403,260,11374
684,2015-09-25,65.53,274395,253846,1121511,1142060,2791812,4124,6842,346,342,11654
685,2015-09-28,66.085,290761,219018,1112077,1183820,2805676,4373,6548,361,290,11572
686,2015-09-29,65.73,282530,248922,1119935,1153543,2804930,4283,6860,332,351,11826
687,2015-09-30,65.39,274438,227256,1142931,1190113,2834738,4304,6489,366,311,11470
688,2015-10-01,65.65,249250,223372,1075405,1101283,2649310,4262,6354,368,297,11281
689,2015-10-02,66.012,414157,123893,1047961,1338225,2924236,8337,2720,462,253,11772
690,2015-10-05,64.749,300955,272575,1123569,1151949,2849048,4558,6830,344,346,12078
691,2015-10-06,63.33,275140,290757,1094415,1078798,2739110,4344,6965,347,357,12013
692,2015-10-07,62.664,296262,243357,1048724,1101629,2689972,5053,6115,415,276,11859
693,2015-10-08,61.37,285463,280535,1048481,1053409,2667888,4520,6982,373,341,12216
694,2015-10-09,61.876,284282,229155,994243,1049370,2557050,4913,6228,390,297,11828
695,2015-10-12,62.275,317819,215350,922518,1024987,2480674,5887,5650,460,247,12244
696,2015-10-13,63.039,407010,118566,866182,1154626,2546384,8994,2491,475,236,12196
697,2015-10-14,62.709,388743,137403,904452,1155792,2586390,8671,2852,436,285,12244
698,2015-10-15,61.403,365173,167267,973411,1171317,2677168,8392,3558,418,320,12688
699,2015-10-16,61.285,305665,235399,1036740,1107006,2684810,5293,6399,456,266,12414
700,2015-10-19,62.262,357174,194374,948103,1110903,2610554,6311,5592,531,213,12647
701,2015-10-20,62.115,301441,263247,1002645,1040839,2608172,5315,6697,425,314,12751
702,2015-10-21,63.005,488896,116167,947633,1320362,2873058,9624,2325,542,222,12713
703,2015-10-22,62.591,421528,138953,964761,1247336,2772578,9148,2956,468,258,12830
704,2015-10-23,62.38,414441,170121,1053857,1298177,2936596,8882,2965,469,260,12576
705,2015-10-26,63.02,510483,112193,967422,1365712,2955810,9941,2169,563,203,12876
706,2015-10-27,64.9,524208,127073,973356,1370491,2995128,10135,2399,572,200,13306
707,2015-10-28,63.95,426937,148940,1097059,1375056,3047992,8968,2952,483,289,12692
708,2015-10-29,64.4,433341,118420,1085713,1400634,3038108,9042,2738,502,246,12528
709,2015-10-30,63.958,422832,168392,1101972,1356412,3049608,8832,3447,473,318,13070
710,2015-11-02,63.665,452209,131717,1033681,1354173,2971780,9542,2734,508,259,13043
711,2015-11-03,62.628,306735,332846,1206668,1180557,3026806,5137,7546,414,354,13451
712,2015-11-05,63.45,328773,256440,1093471,1165804,2844488,5511,6476,467,285,12739
713,2015-11-06,64.598,497898,129342,964047,1332603,2923890,10278,2259,581,224,13342
714,2015-11-09,64.59,420913,139947,973487,1254453,2788800,9986,2431,546,234,13197
715,2015-11-10,64.56,389588,173539,1014166,1230215,2807508,8877,3251,482,307,12917
716,2015-11-11,65.415,493061,136514,972963,1329510,2932048,10221,2379,589,222,13411
717,2015-11-12,66.635,587700,129091,959454,1418063,3094308,10535,2407,584,229,13755
718,2015-11-13,66.777,593933,136705,944753,1401981,3077372,10688,2369,556,234,13847
719,2015-11-16,65.27,556901,140481,951937,1368357,3017676,9923,2932,529,279,13663
720,2015-11-17,65.148,424681,230653,1099456,1293484,3048274,5682,7340,475,340,13837
721,2015-11-18,64.753,423819,199056,1065169,1289932,2977976,6127,6652,509,274,13562
722,2015-11-19,64.618,403735,222800,1131882,1312817,3071234,5729,7182,481,341,13733
723,2015-11-20,64.75,389828,195350,1127227,1321705,3034110,5903,6805,483,327,13518
724,2015-11-23,65.836,552939,100486,1006119,1458572,3118116,10072,2475,553,250,13350
725,2015-11-24,65.452,582518,86035,999073,1495556,3163182,10576,2154,552,220,13502
726,2015-11-25,65.525,625730,84489,1056615,1597856,3364690,10612,2087,540,239,13478
727,2015-11-26,65.837,584210,83821,1080950,1581339,3330320,10864,1997,573,218,13652
728,2015-11-27,66.48,602083,86318,1053071,1568836,3310308,10595,2216,544,223,13578
729,2015-11-30,66.49,565663,161677,1149665,1553651,3430656,10106,3034,501,311,13952
730,2015-12-01,66.61,621848,101806,1004709,1524751,3253114,10611,2367,603,229,13810
731,2015-12-02,67.5,614717,109457,1021369,1526629,3272172,10657,2323,577,226,13783
732,2015-12-03,67.508,618361,123855,957281,1451787,3151284,10739,2545,605,223,14112
733,2015-12-04,68.135,587349,122760,1006611,1471200,3187920,9794,2771,586,235,13386
734,2015-12-07,69.499,631331,119163,1035986,1548154,3334634,10662,2533,622,237,14054
735,2015-12-08,69.4,615509,123134,1086690,1579065,3404398,10430,2633,574,248,13885
736,2015-12-09,69.368,530495,176618,1121655,1475532,3304300,9110,3710,472,345,13637
737,2015-12-10,69.15,512661,193733,1038611,1357539,3102544,9032,3722,472,341,13567
738,2015-12-11,70.362,603227,146050,1049624,1506801,3305702,10038,2911,580,264,13793
739,2015-12-14,70.555,614040,160329,1075276,1528987,3378632,11519,2706,563,235,15023
740,2015-12-15,69.941,350636,156663,909724,1103697,2520720,6110,2834,343,250,9537
741,2015-12-16,70.396,366220,140893,888107,1113434,2508654,6535,2865,427,213,10040
742,2015-12-17,71.183,421920,124312,887668,1185276,2619176,7125,2515,469,188,10297
743,2015-12-18,70.948,504647,137913,915389,1282123,2840072,9006,2874,422,257,12559
744,2015-12-21,71.233,522655,128078,902810,1297387,2850930,9442,2494,514,189,12639
745,2015-12-22,71.233,491132,153970,925759,1262921,2833782,8827,3039,448,239,12553
746,2015-12-23,69.8,311221,372803,1094596,1033014,2811634,4380,7729,399,320,12828
747,2015-12-24,70.24,333361,304998,1056906,1085269,2780534,4642,7188,480,217,12527
748,2015-12-25,70.689,345456,294009,1063717,1115164,2818346,4914,7097,485,206,12702
749,2015-12-28,72.225,505502,122062,942080,1325520,2895164,9510,2461,499,182,12652
750,2015-12-29,72.205,460340,126162,890208,1224386,2701096,8736,2735,396,230,12097
751,2015-12-30,73.59,479096,115154,982207,1346149,2922606,9036,2360,421,173,11990
752,2016-01-04,73.16,412884,140103,1041655,1314436,2909078,8442,3102,397,231,12172
753,2016-01-05,73.316,441726,114114,1002217,1329829,2887886,9053,2624,458,183,12318
754,2016-01-06,74.76,457087,120129,1022691,1359649,2959556,9085,2515,448,183,12231
755,2016-01-11,76.211,478060,149741,976516,1304835,2909152,9956,2516,504,188,13164
756,2016-01-12,77.065,452266,181687,1004457,1275036,2913446,9320,3118,467,211,13116
757,2016-01-13,76.677,469227,174683,1044534,1339078,3027522,9430,3171,461,222,13284
758,2016-01-14,76.051,460803,170713,1063687,1353777,3048980,9405,3199,449,236,13289
759,2016-01-15,77.603,530443,172611,1049456,1407288,3159798,9926,3037,493,206,13662
760,2016-01-18,79.29,510883,182012,1112973,1441844,3247712,9993,3117,511,217,13838
761,2016-01-19,78.561,448155,204466,1134639,1378328,3165588,9108,3573,445,267,13393
762,2016-01-20,81.4,548861,248543,1157814,1458132,3413350,9788,3441,495,217,13941
763,2016-01-21,82.63,462055,143057,953403,1272401,2830916,9215,3229,424,277,13145
764,2016-01-22,78.024,264957,172735,1044696,1136918,2619306,6670,4418,369,317,11774
765,2016-01-25,80.04,264827,119671,1000634,1145790,2530922,6633,4390,431,273,11727
766,2016-01-26,78.3,247591,177431,1059730,1129890,2614642,6146,4928,400,309,11783
767,2016-01-27,77.667,229871,177729,1106794,1158936,2673330,6062,5102,385,311,11860
768,2016-01-28,76.397,203691,199830,1101469,1105330,2610320,5815,5256,388,307,11766
769,2016-01-29,75.43,237564,171816,1068636,1134384,2612400,6274,4935,412,296,11917
770,2016-02-01,77.31,304233,128598,998331,1173966,2605128,7204,4293,479,250,12226
771,2016-02-02,79.755,456361,135322,881874,1202913,2676470,10126,2845,493,220,13684
772,2016-02-03,76.904,390141,145392,852752,1097501,2485786,9248,3209,457,258,13172
773,2016-02-04,76.969,274674,219838,993934,1048770,2537216,6063,6063,394,322,12842
774,2016-02-05,77.47,295675,157816,898909,1036768,2389168,6548,5135,425,269,12377
775,2016-02-08,78.544,417768,147759,844884,1114893,2525304,9617,3389,483,235,13724
776,2016-02-09,79.701,437489,127471,803681,1113699,2482340,10164,2917,457,240,13778
777,2016-02-10,78.606,413057,162769,845434,1095722,2516982,9337,3501,444,261,13543
778,2016-02-11,79.592,464783,144867,825103,1145019,2579772,10386,2863,491,226,13966
779,2016-02-12,78.34,372564,184512,863300,1051352,2471728,8752,3948,414,305,13419
780,2016-02-15,76.95,263109,257227,1014606,1020488,2555430,4315,7743,388,344,12790
781,2016-02-16,77.899,278289,180324,928623,1026588,2413824,5295,6178,445,271,12189
782,2016-02-17,75.032,289617,254283,970611,1005945,2520456,4895,7347,398,336,12976
783,2016-02-18,76.5,250697,263250,1012858,1000305,2527110,4937,8790,422,310,14459
784,2016-02-19,76.986,317021,236938,1002738,1082821,2639518,5715,7538,465,282,14000
785,2016-02-20,77.05,251835,239125,1031975,1044685,2567620,4927,7794,423,300,13444
786,2016-02-22,75.3,231631,310188,1107621,1029064,2678504,4250,9003,388,336,13977
787,2016-02-24,75.711,308962,228440,1012595,1093117,2643114,5296,7813,443,302,13854
788,2016-02-25,75.385,246583,275759,1089714,1060538,2672594,4350,8442,396,346,13534
789,2016-02-26,76.2,259924,283174,1078108,1054858,2676064,4454,8720,393,323,13890
790,2016-02-29,75.2,247092,267159,1082339,1062272,2658862,4216,9034,388,353,13991
791,2016-03-01,73.392,263524,307469,1018883,974938,2564814,4894,9010,389,354,14647
792,2016-03-02,73.07,322649,243558,913613,992704,2472524,5650,8116,465,304,14535
793,2016-03-03,73.171,283751,275463,935786,944074,2439074,5123,8677,443,332,14575
794,2016-03-04,71.97,299780,333154,1009743,976369,2619046,5370,9102,411,362,15245
795,2016-03-07,71.471,298200,302315,1002753,998638,2601906,5311,8957,412,372,15052
796,2016-03-09,71.141,332823,279928,1017457,1070352,2700560,5892,8604,429,356,15281
797,2016-03-10,71.455,329344,256897,1021206,1093653,2701100,6551,7712,490,292,15045
798,2016-03-11,69.883,340469,285602,1108188,1163055,2897314,6654,8236,437,346,15673
799,2016-03-14,69.96,387658,207514,1049774,1229918,2874864,7230,7507,539,258,15534
800,2016-03-15,71.04,301261,106023,707060,902298,2016642,5594,2659,403,175,8831
801,2016-03-16,69.123,274872,165273,702916,812515,1955576,4934,3814,331,269,9348
802,2016-03-17,68.1,319794,325298,869723,864219,2379034,5762,8807,365,314,15248
803,2016-03-18,68.389,306557,293067,820416,833906,2253946,5902,8367,386,267,14922
804,2016-03-21,67.822,305272,286745,812615,831142,2235774,6112,8177,418,303,15010
805,2016-03-22,67.5,327492,308312,847136,866316,2349256,6472,8269,412,312,15465
806,2016-03-23,68.737,377619,272540,840314,945393,2435866,7478,7601,507,232,15818
807,2016-03-24,68.527,571349,155940,853809,1269218,2850316,12942,2455,546,193,16136
808,2016-03-25,68.454,492586,204605,846173,1134154,2677518,12179,2972,488,236,15875
809,2016-03-28,68.47,533246,150604,884270,1266912,2835032,13032,2542,545,194,16313
810,2016-03-29,68.05,607441,137655,884119,1353905,2983120,13968,1922,574,189,16653
811,2016-03-30,68.24,350275,350291,963440,963424,2627430,7249,8993,466,306,17014
812,2016-03-31,67.025,373021,341113,940388,972296,2626818,7426,9068,479,299,17272
813,2016-04-01,67.595,387093,259934,987728,1114887,2749642,7618,8143,517,225,16503
814,2016-04-04,68.7,527142,128687,924120,1322575,2902524,13825,2262,563,200,16850
815,2016-04-05,68.562,516026,138112,878890,1256804,2789832,13191,2458,564,187,16400
816,2016-04-06,67.59,480647,191376,841810,1131081,2644914,12169,3693,472,286,16620
817,2016-04-07,68.028,377107,264402,867470,980175,2489154,7769,7969,541,215,16494
818,2016-04-08,67.15,347234,355573,906317,897978,2507102,7108,8962,438,319,16827
819,2016-04-11,66.773,342571,376298,926294,892567,2537730,6682,9451,434,317,16884
820,2016-04-12,65.715,350862,367111,938828,922579,2579380,6585,9713,420,356,17074
821,2016-04-13,66.31,352693,330469,904914,927138,2515214,7063,9103,478,263,16907
822,2016-04-14,66.11,361411,303215,900241,958437,2523304,7160,8386,489,274,16309
823,2016-04-15,66.447,422523,250528,836613,1008608,2518272,7972,7388,557,215,16132
824,2016-04-18,66.118,533145,165481,824888,1192552,2716066,13587,2623,501,261,16972
825,2016-04-19,65.853,405694,284171,917984,1039507,2647356,7548,9050,471,327,17396
826,2016-04-20,65.157,401507,286375,907746,1022878,2618506,7307,9004,473,319,17103
827,2016-04-21,66.84,395459,213864,839254,1020849,2469426,7914,8099,531,256,16800
828,2016-04-22,66.455,463481,163424,830159,1130216,2587280,13176,2706,532,233,16647
829,2016-04-25,66.567,483263,144501,799461,1138223,2565448,13363,2559,543,233,16698
830,2016-04-26,65.2,491428,181664,820628,1130392,2624112,13156,3414,494,278,17342
831,2016-04-27,65.12,400073,291702,908015,1016386,2616176,8183,8342,514,256,17295
832,2016-04-28,64.719,395398,360689,1004497,1039206,2799790,7699,9641,476,326,18142
833,2016-04-29,64.63,384900,297880,911399,998419,2592598,7940,8397,489,252,17078
834,2016-05-04,66.529,461201,135127,742717,1068791,2407836,13384,2306,566,202,16458
835,2016-05-05,65.89,445129,161500,778923,1062552,2448104,13017,2806,510,263,16596
836,2016-05-06,65.945,457070,141693,768260,1083637,2450660,13130,2572,511,244,16457
837,2016-05-10,66.31,489701,133331,770186,1126556,2519774,13691,2197,544,229,16661
838,2016-05-11,64.978,404722,355053,969290,1018959,2748024,7872,8945,483,305,17605
839,2016-05-12,64.895,396542,332533,894258,958267,2581600,8420,8391,528,256,17595
840,2016-05-13,65.48,392514,336109,897055,953460,2579138,8030,8794,506,282,17612
841,2016-05-16,64.9,376604,376491,952741,952854,2658690,7375,9390,478,319,17562
842,2016-05-17,64.72,409893,353930,912813,968776,2645412,7916,9044,501,308,17769
843,2016-05-18,65.999,430171,340856,899078,988393,2658498,8106,8700,532,258,17596
844,2016-05-19,66.78,569719,200948,817834,1186605,2775106,13852,2928,590,238,17608
845,2016-05-20,66.798,541314,173347,801377,1169344,2685382,13475,2832,535,258,17100
846,2016-05-23,66.808,560742,167961,779174,1171955,2679832,13973,2765,560,235,17533
847,2016-05-24,66.184,527517,236241,821229,1112505,2697492,13256,3708,506,313,17783
848,2016-05-25,65.508,392170,463151,1116194,1045213,3016728,7787,9211,497,306,17801
849,2016-05-26,65.801,415234,398305,1079531,1096460,2989530,8202,8648,520,269,17639
850,2016-05-27,66.144,449221,365425,1023288,1107084,2945018,8985,7917,565,243,17710
851,2016-05-30,65.75,419992,412466,1053597,1061123,2947178,8036,8941,488,307,17772
852,2016-05-31,66.7,458536,373068,1021310,1106778,2959692,8810,8068,552,261,17691
853,2016-06-01,67.14,646283,159945,791734,1278072,2876034,14351,2414,584,223,17572
854,2016-06-02,66.96,749473,156733,804916,1397656,3108778,14754,2423,584,233,17994
855,2016-06-03,65.62,526161,220382,932624,1238403,2917570,9376,5594,528,283,15781
856,2016-06-06,65.245,510896,238849,991217,1263264,3004226,9314,5994,533,282,16123
857,2016-06-07,64.6225,498217,255530,1040930,1283617,3078294,9286,6188,555,291,16320
858,2016-06-08,63.61,523406,298617,1054448,1279237,3155708,9071,8877,518,299,18765
859,2016-06-09,64.3275,534990,242379,1020656,1313267,3111292,9746,8073,585,238,18642
860,2016-06-10,65.28,557346,221018,1033280,1369608,3181252,9837,7235,604,218,17894
861,2016-06-14,66.14,554265,148939,953411,1358737,3015352,14021,2298,552,201,17072
862,2016-06-15,65.5125,308776,176813,789086,921049,2195724,6233,2575,342,219,9369
863,2016-06-16,65.78,368467,119634,787107,1035940,2311148,7524,1914,410,193,10041
864,2016-06-17,64.85,328601,342429,830366,816538,2317934,5836,8864,395,240,15335
865,2016-06-20,64.2975,350862,332691,779615,797786,2260954,6252,8776,380,251,15659
866,2016-06-21,63.755,362801,293074,732284,802011,2190170,6917,8309,407,226,15859
867,2016-06-22,64.89,419280,269067,711614,861827,2261788,7765,7416,458,184,15823
868,2016-06-23,63.85,480027,157958,707643,1029712,2375340,12500,2413,436,211,15560
869,2016-06-24,65.2625,476075,137334,703665,1042406,2359480,12050,2160,423,189,14822
870,2016-06-27,65.4875,531921,110343,735023,1156601,2533888,13077,1803,471,177,15528
871,2016-06-28,64.1,495464,177991,774555,1092028,2540038,12302,3021,420,247,15990
872,2016-06-29,63.85,407479,306587,864490,965382,2543938,7207,8801,408,288,16704
873,2016-06-30,63.99,407585,251459,800440,956566,2416050,7548,8158,455,236,16397
874,2016-07-01,63.8,415932,260511,866423,1021844,2564710,7530,8133,439,236,16338
875,2016-07-04,63.935,439823,256707,855560,1038676,2590766,7782,8217,446,219,16664
876,2016-07-05,64.3175,627007,123030,773954,1277931,2801922,13878,1936,525,175,16514
877,2016-07-06,64.2075,592804,129972,812619,1275451,2810846,13384,2275,495,188,16342
878,2016-07-07,64.565,416389,289651,921675,1048413,2676128,7992,7757,484,216,16449
879,2016-07-08,63.98,455818,280604,940412,1115626,2792460,7795,7994,448,257,16494
880,2016-07-11,64.2,433948,271349,904173,1066772,2676242,7637,7967,457,242,16303
881,2016-07-12,63.89,438617,304414,947959,1082162,2773152,7604,8299,451,244,16598
882,2016-07-13,63.85,477626,243554,866414,1100486,2688080,8235,7635,499,194,16563
883,2016-07-14,62.85,530250,328962,916828,1118116,2894156,8159,8633,454,276,17522
884,2016-07-15,63.51,520720,258133,880708,1143295,2802856,8363,7798,484,214,16859
885,2016-07-18,62.8425,529925,299363,939325,1169887,2938500,7857,8695,447,279,17278
886,2016-07-19,63.5475,582961,237930,891288,1236319,2948498,8732,7656,508,194,17090
887,2016-07-20,63.74,564451,197128,879337,1246660,2887576,9576,6579,508,219,16882
888,2016-07-21,64.37,712761,88177,846641,1471225,3118804,14618,1940,551,183,17292
889,2016-07-22,64.88,666963,101181,828775,1394557,2991476,14374,2023,539,188,17124
890,2016-07-25,65.415,719016,132354,822049,1408711,3082130,14378,2180,545,189,17292
891,2016-07-26,65.9475,694140,154256,811322,1351206,3010924,13403,2681,492,216,16792
892,2016-07-27,65.9275,669995,131315,780097,1318777,2900184,13658,2438,512,201,16809
893,2016-07-28,66.615,743150,136710,759852,1366292,3006004,13817,2712,511,203,17243
894,2016-07-29,66.035,662874,150375,800249,1312748,2926246,12830,2999,444,257,16530
895,2016-08-01,66.895,692832,120378,812920,1385374,3011504,13512,2575,497,208,16792
896,2016-08-02,66.6475,663874,139023,806902,1331753,2941552,13130,2829,487,222,16668
897,2016-08-03,66.27,654444,145343,808568,1317669,2926024,12802,3213,466,229,16710
898,2016-08-04,65.7875,639542,204374,888649,1323817,3056382,12642,3769,464,270,17145
899,2016-08-05,65.5475,480729,215091,1049532,1315170,3060522,7980,8315,456,271,17022
900,2016-08-08,64.615,499656,227759,1084125,1356022,3167562,8104,8367,457,266,17194
901,2016-08-09,64.765,533917,156777,1086798,1463938,3241430,8703,7705,508,227,17143
902,2016-08-10,64.87,545032,209566,1119906,1455372,3329876,9041,7791,510,225,17567
903,2016-08-11,64.325,553942,193812,1156621,1516751,3421126,8910,7773,513,222,17418
904,2016-08-12,64.75,564754,152648,1099333,1511439,3328174,9038,7357,559,182,17136
905,2016-08-15,64.03,533578,219525,1169798,1483851,3406752,8630,8242,490,257,17619
906,2016-08-16,63.775,554079,157953,1079593,1475719,3267344,9008,7537,520,218,17283
907,2016-08-17,63.825,583971,137390,1090538,1537119,3349018,9595,6986,555,186,17322
908,2016-08-18,63.65,567761,221909,1204613,1550465,3544748,9076,7856,512,235,17679
909,2016-08-19,63.9,580467,190666,1146232,1536033,3453398,9709,7307,552,178,17746
910,2016-08-22,64.8125,794219,95591,1018980,1717608,3626398,15500,1785,591,161,18037
911,2016-08-23,64.6,719823,134361,974785,1560247,3389216,14806,2510,510,218,18044
912,2016-08-24,65.17,765777,84715,913015,1594077,3357584,15192,1852,583,179,17806
913,2016-08-25,64.6625,707905,139781,1008926,1577050,3433662,14854,2571,517,231,18173
914,2016-08-26,64.86,541545,306444,1210572,1445673,3504234,9247,7920,525,234,17926
915,2016-08-29,64.75,561896,237366,1058602,1383132,3240996,9623,7318,550,197,17688
916,2016-08-30,65.25,739114,92242,971545,1618417,3421318,14833,2126,576,197,17732
917,2016-08-31,65.315,778578,79913,933680,1632345,3424516,15484,1706,623,168,17981
918,2016-09-01,65.92,743603,104099,945238,1584742,3377682,14871,2108,614,181,17774
919,2016-09-02,65.095,508928,340006,1273520,1442442,3564896,8703,8017,530,250,17500
920,2016-09-05,65.08,503747,312840,1267176,1458083,3541846,8831,7876,553,245,17505
921,2016-09-06,64.5625,525070,349251,1300479,1476298,3651098,8938,8124,526,264,17852
922,2016-09-07,64.135,535990,345522,1303797,1494265,3679574,8961,8064,541,246,17812
923,2016-09-08,63.9975,568220,379259,1342416,1531377,3821272,9431,8106,538,251,18326
924,2016-09-09,64.82,745636,98020,1045926,1693542,3583124,15297,1749,608,172,17826
925,2016-09-12,64.5875,681551,113702,1048068,1615917,3459238,14500,2200,558,215,17473
926,2016-09-13,65.2975,688277,99329,1022815,1611763,3422184,14671,1808,588,174,17241
927,2016-09-14,65.16,658557,95997,1024764,1587324,3366642,14045,1850,551,179,16625
928,2016-09-15,64.775,451179,127176,752814,1076817,2407986,7239,2087,391,208,9925
929,2016-09-16,65.12,486957,79337,778218,1185838,2530350,7890,1854,448,168,10360
930,2016-09-19,64.65,473315,364301,879888,988902,2706406,7008,8040,427,244,15719
931,2016-09-20,64.7775,455956,298232,809899,967623,2531710,7039,7684,438,223,15384
932,2016-09-21,63.81,528986,337188,806829,998627,2671630,7687,7950,450,252,16339
933,2016-09-22,63.7025,641123,336014,807145,1112254,2896536,8789,7776,486,250,17301
934,2016-09-23,64.06,631100,299083,822983,1155000,2908166,9044,7326,491,228,17089
935,2016-09-26,63.95,623855,301856,845585,1167584,2938880,8853,7394,499,227,16973
936,2016-09-27,63.86,664708,244342,818871,1239237,2967158,9660,6752,558,188,17158
937,2016-09-28,63.04,648674,276627,823269,1195316,2943886,9191,7107,523,212,17033
938,2016-09-29,63.08,709582,331647,894859,1272794,3208882,9230,7830,491,256,17807
939,2016-09-30,62.805,748124,319751,893262,1321635,3282772,9568,7413,499,245,17725
940,2016-10-03,62.29,788566,321434,984094,1451226,3545320,9954,7607,508,249,18318
941,2016-10-04,62.665,791586,273953,975203,1492836,3533578,10312,7179,537,223,18251
942,2016-10-05,62.4375,768834,314629,1045148,1499353,3627964,9856,7709,519,252,18336
943,2016-10-06,62.13,771273,343375,1063043,1490941,3668632,9868,7987,522,255,18632
944,2016-10-07,62.2125,811193,322679,1023982,1512496,3670350,10212,7434,542,228,18416
945,2016-10-10,62.005,801150,335316,1024157,1489991,3650614,9907,7707,504,245,18363
946,2016-10-11,62.6625,992232,106528,853623,1739327,3691710,14748,2610,551,199,18108
947,2016-10-12,63.02,1034389,87845,883819,1830363,3836416,15647,1845,575,181,18248
948,2016-10-13,63.03,1014987,74916,887252,1827323,3804478,15538,1673,558,196,17965
949,2016-10-14,62.96,1000280,91048,874816,1784048,3750192,15594,2041,562,209,18406
950,2016-10-17,63.11,918449,167159,899704,1650994,3636306,14667,2950,549,225,18391
951,2016-10-18,62.81,916060,157661,889775,1648174,3611670,14694,3025,540,229,18488
952,2016-10-19,62.285,750527,404587,1000498,1346438,3502050,9806,8279,506,286,18877
953,2016-10-20,62.4875,740875,341488,981878,1381265,3445506,10328,7602,551,234,18715
954,2016-10-21,62.37,715650,343412,980501,1352739,3392302,10128,7793,532,230,18683
955,2016-10-24,62.1825,749521,358102,939678,1331097,3378398,10313,7705,512,253,18783
956,2016-10-25,62.24,759425,349183,885320,1295562,3289490,10499,7753,528,237,19017
957,2016-10-26,62.91,1016994,83300,821075,1754769,3676138,16027,1672,589,174,18462
958,2016-10-27,62.7025,963407,98310,883146,1748243,3693106,15658,2117,549,215,18539
959,2016-10-28,63.02,997493,75022,898737,1821208,3792460,16109,1710,582,186,18587
960,2016-10-31,63.375,1008851,76586,930045,1862310,3877792,16098,1796,610,188,18692
961,2016-11-01,63.32,914291,123234,943919,1734976,3716420,15145,2394,533,228,18300
962,2016-11-02,63.515,942975,78406,923050,1787619,3732050,15365,1885,623,175,18048
963,2016-11-03,63.58,938407,57751,905241,1785897,3687296,15410,1666,616,165,17857
964,2016-11-07,63.6325,980325,69990,929353,1839688,3819356,15566,1832,578,195,18171
965,2016-11-08,63.7625,966631,70303,918355,1814683,3769972,15307,2055,566,199,18127
966,2016-11-09,63.89,587263,256801,1166196,1496658,3506918,8328,7934,469,261,16992
967,2016-11-10,65.4725,691120,154570,1076742,1613292,3535724,12474,3663,554,192,16883
968,2016-11-11,65.72,713381,140298,1104363,1677446,3635488,13266,2833,582,202,16883
969,2016-11-14,66.0325,736970,137852,1094293,1693411,3662526,13461,2772,572,197,17002
970,2016-11-15,64.195,602914,173113,1199131,1628932,3604090,10758,4710,499,273,16240
971,2016-11-16,64.7175,552737,126312,1167239,1593664,3439952,10723,4256,525,236,15740
972,2016-11-17,64.8,571839,157066,1224014,1638787,3591706,11208,4268,503,256,16235
973,2016-11-18,64.7025,565067,144775,1184570,1604862,3499274,11340,4164,521,220,16245
974,2016-11-21,63.91,582840,176668,1206367,1612539,3578414,11217,5526,491,270,17504
975,2016-11-22,63.7825,597671,136143,1147662,1609190,3490666,11412,4917,531,222,17082
976,2016-11-23,64.4625,734089,99317,1076554,1711326,3621286,14066,2207,571,188,17032
977,2016-11-24,64.485,707515,98630,1065025,1673910,3545080,13975,2344,540,232,17091
978,2016-11-25,64.95,733721,87411,1043358,1689668,3554158,14228,2066,574,200,17068
979,2016-11-28,64.84,713679,88304,1059115,1684490,3545588,13969,2254,539,215,16977
980,2016-11-29,65.1125,711139,95502,1072873,1688510,3568024,13805,2248,596,190,16839
981,2016-11-30,64.14,565892,234557,1273299,1604634,3678382,10341,5540,511,265,16657
982,2016-12-01,63.98,536979,256384,1279404,1559999,3632766,8452,7550,506,270,16778
983,2016-12-02,63.88,546547,236906,1298476,1608117,3690046,8686,7319,541,271,16817
984,2016-12-05,63.82,547334,279616,1321683,1589401,3738034,8635,7640,495,296,17066
985,2016-12-06,63.8725,561709,217448,1216891,1561152,3557200,9255,6985,552,262,17054
986,2016-12-07,63.2275,551672,238366,1255625,1568931,3614594,9085,7307,523,290,17205
987,2016-12-08,63.28,558679,249106,1253649,1563222,3624656,8923,7411,508,300,17142
988,2016-12-09,62.495,544597,252001,1231104,1523700,3551402,8879,7273,505,312,16969
989,2016-12-12,61.05,571536,239443,1192219,1524312,3527510,9185,6924,489,287,16885
990,2016-12-13,60.605,603232,228158,1268961,1644035,3744386,9598,6882,499,292,17271
991,2016-12-14,62.1,599329,188982,1133815,1544162,3466288,9906,6367,541,222,17036
992,2016-12-15,61.7475,521457,81555,950569,1390471,2944052,10841,1374,382,161,12758
993,2016-12-16,62.0825,523936,104268,943507,1363175,2934886,10670,1822,405,182,13079
994,2016-12-19,61.9475,555093,100136,915346,1370303,2940878,10941,1997,430,178,13546
995,2016-12-20,61.46,549839,186734,996576,1359681,3092830,10644,2787,387,218,14036
996,2016-12-21,61.1675,509910,228166,1038797,1320541,3097414,7109,6489,388,221,14207
997,2016-12-22,60.965,555191,220943,989256,1323504,3088894,7480,6972,411,220,15083
998,2016-12-23,61.04,629701,169079,906545,1367167,3072492,8153,6124,470,178,14925
999,2016-12-26,60.99,571181,206566,947709,1312324,3037780,7738,6599,411,216,14964
1000,2016-12-26,60.99,571181,206566,947709,1312324,3037780,7738,6599,411,216,14964
1001,2016-12-27,60.67,566615,261765,930652,1235502,2994534,7586,7169,390,282,15427
1002,2016-12-28,60.335,572983,249875,877345,1200453,2900656,7457,7056,389,271,15173
1003,2016-12-29,60.4,566365,190448,846343,1222260,2825416,7527,6458,433,207,14625
1004,2016-12-30,61.2725,681941,98259,631280,1214962,2626442,11801,1465,412,148,13826
1005,2017-01-03,60.9025,653515,140262,692869,1206122,2692768,11274,2080,395,179,13928
1006,2017-01-04,60.46,681467,118453,664702,1227716,2692338,11925,1870,412,168,14375
1007,2017-01-05,59.45,630856,172266,744048,1202638,2749808,7965,6396,405,194,14960
1008,2017-01-06,59.62,599605,154998,745239,1189846,2689688,7743,6355,422,187,14707
1009,2017-01-09,60.09,626982,145615,760458,1241825,2774880,8268,6199,444,174,15085
1010,2017-01-10,60.1675,616226,152126,788683,1252783,2809818,8041,6241,431,185,14898
1011,2017-01-11,59.7475,733736,103344,712590,1342982,2892652,12554,1981,455,162,15152
1012,2017-01-12,59.3325,668263,222874,914696,1360085,3165918,8606,6684,420,217,15927
1013,2017-01-13,59.66,642165,183323,880547,1339389,3045424,8473,6277,449,185,15384
1014,2017-01-16,59.87,727147,127537,827862,1427472,3110018,11927,2970,446,187,15530
1015,2017-01-17,59.41,691322,237985,977860,1431197,3338364,8952,6681,445,216,16294
1016,2017-01-18,59.56,668017,201637,966298,1432678,3268630,8955,6494,488,197,16134
1017,2017-01-19,59.72,579663,107153,1032092,1504602,3223510,12911,1840,520,153,15424
1018,2017-01-20,59.755,574074,110919,1120251,1583406,3388650,12690,2023,463,181,15357
1019,2017-01-23,59.5175,599301,130309,1139468,1608460,3477538,12941,2408,447,205,16001
1020,2017-01-24,59.24,551683,208154,1159540,1503069,3422446,9110,6415,420,235,16180
1021,2017-01-25,59.5175,602021,168941,1090646,1523726,3385334,9628,5912,488,210,16238
1022,2017-01-26,60.4375,651457,172266,1133540,1612731,3569994,12403,2673,504,184,15764
1023,2017-01-27,59.83,668886,158654,1137307,1647539,3612386,13075,2295,443,223,16036
1024,2017-01-30,59.93,678178,125701,1053090,1605567,3462536,13512,1969,532,177,16190
1025,2017-01-31,60.16,711260,138960,1020534,1592834,3463588,13851,1960,526,183,16520
1026,2017-02-01,60.1325,701305,132794,1007218,1575729,3417046,13720,1964,550,169,16403
1027,2017-02-02,59.425,672242,283014,1126552,1515780,3597588,10407,6332,528,203,17470
1028,2017-02-03,58.9625,730036,229923,1085240,1585353,3630552,10723,6222,492,224,17661
1029,2017-02-06,58.9025,755288,192249,1036318,1599357,3583212,11175,6017,527,188,17907
1030,2017-02-07,59.32,762192,183823,1041362,1619731,3607108,11353,5767,527,185,17832
1031,2017-02-08,59.23,744638,208813,1001819,1537644,3492914,11152,5752,515,208,17627
1032,2017-02-09,58.95,766388,273127,1037168,1530429,3607112,10950,6346,504,221,18021
1033,2017-02-10,58.24,807892,262902,1023457,1568447,3662698,11128,6410,496,276,18310
1034,2017-02-13,57.98,868476,212088,1175655,1832043,4088262,11478,6273,526,263,18540
1035,2017-02-14,57.1075,868994,226858,1173731,1815867,4085450,11370,6321,519,238,18448
1036,2017-02-15,57.265,891259,159963,1204274,1935570,4191066,11509,5273,563,203,17548
1037,2017-02-16,57.6,841046,159742,1265121,1946425,4212334,11963,5279,611,191,18044
1038,2017-02-17,58.4175,859721,107753,1265752,2017720,4250946,15034,1965,630,178,17807
1039,2017-02-20,57.95,834752,105162,1247468,1977058,4164440,14640,2192,541,224,17597
1040,2017-02-21,57.4025,796556,201155,1273943,1869344,4140998,11469,5695,519,253,17936
1041,2017-02-22,58.0725,807623,173455,1255157,1889325,4125560,11369,5256,596,187,17408
1042,2017-02-24,58.445,827487,131305,1240291,1936473,4135556,13991,2042,596,180,16809
1043,2017-02-27,58.0525,867712,148565,1221682,1940829,4178788,14446,2289,577,208,17520
1044,2017-02-28,58.2875,912296,120898,1225351,2016749,4275294,14709,1957,609,175,17450
1045,2017-03-01,58.3075,844483,135542,1210575,1919516,4110116,14006,2389,576,192,17163
1046,2017-03-02,58.805,904262,139227,1082395,1847430,3973314,15464,2179,640,187,18470
1047,2017-03-03,58.23,859695,150121,1138248,1847822,3995886,14960,2571,608,210,18349
1048,2017-03-06,58.19,818259,257433,1195229,1756055,4026976,11456,6539,578,240,18813
1049,2017-03-07,58.18,836467,212660,1135586,1759393,3944106,11247,6437,556,240,18480
1050,2017-03-09,59.3175,761547,112956,1092556,1741147,3708206,13864,2214,608,178,16864
1051,2017-03-10,58.9975,792098,129472,1092295,1754921,3768786,14424,2147,596,203,17370
1052,2017-03-13,58.7725,786196,127560,1090998,1749634,3754388,14487,2209,561,197,17454
1053,2017-03-14,59.16,799904,106203,1062917,1756618,3725642,14466,1968,564,191,17189
1054,2017-03-15,58.39,798212,128637,1227585,1897160,4051594,15761,2051,596,196,18604
1055,2017-03-16,57.79,746400,168583,859687,1437504,3212174,10532,3762,384,202,14880
1056,2017-03-17,57.22,744859,163912,868013,1448960,3225744,10997,3807,429,162,15395
1057,2017-03-20,57.3025,767905,144415,909910,1533400,3355630,11328,3890,417,172,15807
1058,2017-03-21,57.7,780682,160743,920163,1540102,3401690,11441,3592,483,148,15664
1059,2017-03-22,57.7875,799049,117410,923587,1605226,3445272,12864,2088,475,156,15583
1060,2017-03-23,57.465,818753,129213,934747,1624287,3507000,12874,2446,453,196,15969
1061,2017-03-24,56.88,825211,194855,942290,1572646,3535002,11646,4341,448,204,16639
1062,2017-03-27,56.9025,847717,165282,895032,1577467,3485498,10170,5500,446,194,16310
1063,2017-03-28,57.0075,856318,174773,906145,1587690,3524926,10218,5674,442,207,16541
1064,2017-03-29,56.61,862986,222186,902936,1543736,3531844,10097,6033,424,225,16779
1065,2017-03-30,56.08,923969,191556,1041556,1773969,3931050,10587,5898,427,225,17137
1066,2017-03-31,56.28,893997,129784,908225,1672438,3604444,10685,5296,490,152,16623
1067,2017-04-03,56.115,906106,131928,907917,1682095,3628046,10739,5442,487,169,16837
1068,2017-04-04,56.09,919003,113188,949789,1755604,3737584,13129,3049,442,203,16823
1069,2017-04-05,56.38,869264,154904,1018677,1733037,3775882,10671,5571,487,177,16906
1070,2017-04-06,56.3975,849761,160010,988647,1678398,3676816,10239,5863,475,203,16780
1071,2017-04-07,57.25,866164,131159,838700,1573705,3409728,13260,2416,511,150,16337
1072,2017-04-10,57.1675,831407,143731,864857,1552533,3392528,13301,2580,498,171,16550
1073,2017-04-11,56.8975,821297,134691,798117,1484723,3238828,13197,2595,493,166,16451
1074,2017-04-12,56.595,805259,180110,837463,1462612,3285444,10758,5023,486,185,16452
1075,2017-04-13,56.2825,803732,226760,862462,1439434,3332388,10187,6077,427,240,16931
1076,2017-04-14,56.3625,815163,201491,877822,1491494,3385970,10620,5642,468,176,16906
1077,2017-04-17,55.9425,856461,237217,899450,1518694,3511822,10545,5982,437,226,17190
1078,2017-04-18,56.25,872659,173907,907922,1606674,3561162,10853,5284,484,180,16801
1079,2017-04-19,56.5675,988005,107983,870559,1750581,3717128,13871,2370,513,158,16912
1080,2017-04-20,56.1975,899326,126313,860380,1633393,3519412,13666,2375,478,208,16727
1081,2017-04-21,56.455,922974,113035,857739,1667678,3561426,13887,1949,538,131,16505
1082,2017-04-24,55.8475,823431,207546,971554,1587439,3589970,10339,5721,453,219,16732
1083,2017-04-25,56.1675,851285,168222,927887,1610950,3558344,10737,5119,522,148,16526
1084,2017-04-26,57.16,877362,156829,905203,1625736,3565130,13146,2494,505,165,16310
1085,2017-04-27,56.9725,861551,142880,894393,1613064,3511888,13355,2128,552,133,16168
1086,2017-04-28,56.9225,852535,160607,973413,1665341,3651896,12769,2484,472,178,15903
1087,2017-05-02,57.0,875630,140175,956153,1691608,3663566,13140,2154,543,147,15984
1088,2017-05-03,57.3825,906693,134710,950663,1722646,3714712,13482,2026,548,134,16190
1089,2017-05-04,58.3975,811020,210491,934178,1534707,3490396,12908,2497,557,137,16099
1090,2017-05-05,57.9325,722667,169133,945727,1499261,3336788,12036,2569,497,194,15296
1091,2017-05-10,57.435,687878,202593,982069,1467354,3339894,11072,3762,441,230,15505
1092,2017-05-11,57.05,718016,191416,1008899,1535499,3453830,11055,4088,458,210,15811
1093,2017-05-12,57.085,751413,145555,1034747,1640605,3572320,11335,3614,513,174,15636
1094,2017-05-15,56.345,803545,190228,1076347,1689664,3759784,11614,4031,475,224,16344
1095,2017-05-16,56.58,837389,144024,1060780,1754145,3796338,12152,3435,538,171,16296
1096,2017-05-17,57.085,814124,158113,1048051,1704062,3724350,12402,2972,567,161,16102
1097,2017-05-18,57.58,776247,167878,1034109,1642478,3620712,12270,2464,544,164,15442
1098,2017-05-19,56.9,756963,178682,1013253,1591534,3540432,11960,2926,453,221,15560
1099,2017-05-22,56.64,741428,185796,992863,1548495,3468582,11181,3748,503,176,15608
1100,2017-05-23,56.36,783296,212988,1010370,1580678,3587332,11508,4220,459,282,16469
1101,2017-05-24,56.405,828372,166555,982584,1644401,3621912,12347,3339,545,179,16410
1102,2017-05-25,56.96,818698,170344,992673,1641027,3622742,10933,4248,564,179,15924
1103,2017-05-26,56.5,819245,105998,940070,1653317,3518630,11477,3340,518,177,15512
1104,2017-05-29,56.45,820558,161014,955612,1615156,3552340,11185,4101,480,210,15976
1105,2017-05-30,56.54,855856,115386,937082,1677552,3585876,11868,3348,582,175,15973
1106,2017-05-31,56.56,911819,122814,922511,1711516,3668660,11884,3146,589,167,15786
1107,2017-06-01,56.385,812405,204513,946972,1554864,3518754,10329,4821,491,227,15868
1108,2017-06-02,56.6575,790548,132774,1008013,1665787,3597122,10442,4259,500,206,15407
1109,2017-06-05,56.6,838879,133024,1004023,1709878,3685804,10618,4223,531,172,15544
1110,2017-06-06,56.52,820398,136761,1020839,1704476,3682474,10566,4204,525,191,15486
1111,2017-06-07,57.0825,898310,94645,1001362,1805027,3799344,13191,1834,561,164,15750
1112,2017-06-08,56.9175,862287,120336,956546,1698497,3637666,12687,2495,505,208,15895
1113,2017-06-09,57.03,837138,113705,990718,1714151,3655712,12604,2277,522,172,15575
1114,2017-06-13,56.98,812660,133218,972492,1651934,3570304,11856,2940,535,194,15525
1115,2017-06-14,57.435,864130,91778,1027453,1799805,3783166,12605,1768,552,159,15084
1116,2017-06-15,57.89,650082,93138,890955,1447899,3082074,9278,1672,454,124,11528
1117,2017-06-16,57.77,646043,110905,967242,1502380,3226570,9333,2088,413,152,11986
1118,2017-06-19,58.4425,707364,136662,1001033,1571735,3416794,9978,2454,428,163,13023
1119,2017-06-20,59.6325,630200,229134,1118614,1519680,3497628,9485,3228,431,191,13335
1120,2017-06-21,60.3225,573134,229427,1110177,1453884,3366622,9129,3425,404,186,13144
1121,2017-06-22,59.9375,556615,243994,1121672,1434293,3356574,8853,3570,369,222,13014
1122,2017-06-23,59.385,605335,216372,976756,1365719,3164182,8849,3824,386,216,13275
1123,2017-06-26,58.77,594666,194455,1005323,1405534,3199978,8430,4056,412,191,13089
1124,2017-06-27,59.49,624225,171471,1038388,1491142,3325226,8949,3695,404,169,13217
1125,2017-06-28,59.2,626352,177562,1008916,1457706,3270536,9144,3253,410,181,12988
1126,2017-06-29,59.425,625872,207887,1059006,1476991,3369756,9246,3247,412,177,13082
1127,2017-06-30,58.93,616196,218505,1167645,1565336,3567682,8888,3498,381,177,12944
1128,2017-07-03,59.265,633145,181706,1118835,1570274,3503960,8732,3761,404,166,13063
1129,2017-07-04,59.4125,605213,180981,1128494,1552726,3467414,8506,3945,428,188,13067
1130,2017-07-05,59.9825,720478,163053,1130608,1688033,3702172,10404,2349,472,159,13384
1131,2017-07-06,60.16,660671,206845,1143614,1597440,3608570,9482,3198,381,203,13264
1132,2017-07-07,60.355,649031,188366,1151717,1612382,3601496,9736,2728,413,171,13048
1133,2017-07-10,60.23,623924,212448,1221142,1632618,3690132,9531,3072,390,192,13185
1134,2017-07-11,60.76,658107,216839,1202172,1643440,3720558,9718,2965,462,164,13309
1135,2017-07-12,60.005,595166,266068,1335444,1664542,3861220,8277,4662,361,223,13523
1136,2017-07-13,59.8225,608614,234991,1278011,1651634,3773250,8283,4543,405,203,13434
1137,2017-07-14,59.09,667380,248258,1299417,1718539,3933594,8864,4228,378,221,13691
1138,2017-07-17,59.3275,693402,189868,1256755,1760289,3900314,9880,3433,428,162,13903
1139,2017-07-18,59.18,637939,227209,1336723,1747453,3949324,8958,4306,384,211,13859
1140,2017-07-19,59.0,662517,237615,1345720,1770622,4016474,9119,4373,398,259,14149
1141,2017-07-20,58.935,671860,204825,1349102,1816137,4041924,8469,5150,386,212,14217
1142,2017-07-21,59.36,722947,135317,1283801,1871431,4013496,8997,4363,411,180,13951
1143,2017-07-24,60.005,770285,132574,1288958,1926669,4118486,10936,2351,421,161,13869
1144,2017-07-25,59.87,741643,116703,1205856,1830796,3894998,10684,2276,391,174,13525
1145,2017-07-26,59.3975,714424,190844,1274519,1798099,3977886,9585,3509,363,221,13678
1146,2017-07-27,59.4975,677086,221990,1331279,1786375,4016730,8097,5239,353,226,13915
1147,2017-07-28,59.565,713495,179192,1303739,1838042,4034468,8519,4645,387,187,13738
1148,2017-07-31,59.78,809918,136320,1261356,1934954,4142548,11077,2127,410,165,13779
1149,2017-08-01,60.35,799581,152288,1268385,1915678,4135932,11141,2050,417,164,13772
1150,2017-08-02,60.59,765737,179894,1300151,1885994,4131776,10600,2445,384,172,13601
1151,2017-08-03,60.36,707506,239274,1320732,1788964,4056476,9904,3345,358,205,13812
1152,2017-08-04,59.97,694465,269983,1297872,1722354,3984674,8001,5225,351,220,13797
1153,2017-08-07,60.0325,676491,243361,1252829,1685959,3858640,8298,5205,358,204,14065
1154,2017-08-08,59.8175,674791,292740,1341940,1723991,4033462,8021,5564,340,228,14153
1155,2017-08-09,59.9825,733909,225179,1219750,1728480,3907318,8777,4454,387,179,13797
1156,2017-08-10,60.11,687131,234748,1226718,1679101,3827698,8289,4861,371,203,13724
1157,2017-08-11,59.8625,710584,223300,1196831,1684115,3814830,8947,4203,357,197,13704
1158,2017-08-14,59.87,754463,251713,1195794,1698544,3900514,8859,4976,363,245,14443
1159,2017-08-15,59.7125,736022,196694,1174928,1714256,3821900,8680,4564,386,180,13810
1160,2017-08-16,59.3775,781185,265953,1197179,1712411,3956728,8996,4978,376,202,14552
1161,2017-08-17,59.225,771430,230954,1186539,1727015,3915938,9109,4882,376,200,14567
1162,2017-08-18,59.0,758075,198917,1185564,1744722,3887278,9157,4583,397,174,14311
1163,2017-08-21,59.145,748958,245904,1257356,1760410,4012628,8953,5119,383,203,14658
1164,2017-08-22,59.07,768325,254379,1234632,1748578,4005914,9055,5043,374,215,14687
1165,2017-08-23,59.065,793241,216504,1221452,1798189,4029386,9351,4580,416,188,14535
1166,2017-08-24,59.1575,842635,185990,1214276,1870921,4113822,10226,3922,436,153,14737
1167,2017-08-25,58.575,813252,284927,1295746,1824071,4217996,9510,4711,390,204,14815
1168,2017-08-28,58.435,797484,268056,1306986,1836414,4208940,9474,4807,396,188,14865
1169,2017-08-29,58.835,815473,206194,1246603,1855882,4124152,9678,4093,424,169,14364
1170,2017-08-30,58.56,795642,266010,1258932,1788564,4109148,9437,4845,382,214,14878
1171,2017-08-31,58.02,791596,249662,1264611,1806545,4112414,9234,4688,379,204,14505
1172,2017-09-01,57.52,785409,241928,1293864,1837345,4158546,9661,4557,386,192,14796
1173,2017-09-04,57.8475,781711,195928,1299014,1884797,4161450,9758,4383,413,166,14720
1174,2017-09-05,57.52,814738,240228,1309955,1884465,4249386,9728,4688,389,192,14997
1175,2017-09-06,57.35,813003,202289,1299532,1910246,4225070,9935,4480,389,196,15000
1176,2017-09-07,56.9,818675,227762,1352597,1943510,4342544,9673,4764,380,204,15021
1177,2017-09-08,57.3675,823622,159903,1301160,1964879,4249564,10153,4044,410,169,14776
1178,2017-09-11,57.22,780461,170000,1341174,1951635,4243270,9867,4386,391,195,14839
1179,2017-09-12,57.71,854618,130204,1343658,2068072,4396552,11955,2185,431,149,14720
1180,2017-09-13,57.96,824139,149617,1338683,2013205,4325644,11750,2254,442,146,14592
1181,2017-09-14,57.5,798644,206108,1418804,2011340,4434896,11183,3178,396,208,14965
1182,2017-09-15,57.69,835954,162551,1395265,2068668,4462438,11805,2459,420,169,14853
1183,2017-09-18,58.11,853629,161519,1346590,2038700,4400438,11969,2003,443,158,14573
1184,2017-09-19,58.1275,836653,160122,1343911,2020442,4361128,11729,1982,477,143,14331
1185,2017-09-20,58.1225,784105,221612,1378003,1940496,4324216,11274,2538,391,207,14410
1186,2017-09-21,57.9,603179,125247,1135582,1613514,3477522,7408,1920,342,150,9820
1187,2017-09-22,57.5,643142,183771,1211637,1671008,3709558,7454,4568,315,240,12577
1188,2017-09-25,57.555,603695,196787,1220406,1627314,3648202,7185,4602,324,241,12352
1189,2017-09-26,57.82,701870,137565,1201543,1765848,3806826,9779,2293,410,149,12631
1190,2017-09-27,58.195,726446,123075,1157858,1761229,3768608,9932,2098,423,141,12594
1191,2017-09-28,57.91,713335,156983,1116488,1672840,3659646,10100,2557,347,181,13185
1192,2017-09-29,57.48,755147,217811,1148429,1685765,3807152,8971,3751,340,228,13290
1193,2017-10-02,57.9125,699396,160880,1140120,1678636,3679032,9007,3360,384,144,12895
1194,2017-10-03,57.9,726762,139208,1118343,1705897,3690210,10357,2230,388,138,13113
1195,2017-10-04,57.6875,741641,218814,1151829,1674656,3786940,10135,2900,344,194,13573
1196,2017-10-05,57.6975,716497,237708,1168368,1647157,3769730,9163,3967,361,205,13696
1197,2017-10-06,58.19,764788,167336,1137587,1735039,3804750,10159,2330,400,138,13027
1198,2017-10-09,58.33,699186,178643,1146182,1666725,3690736,9804,2724,399,145,13072
1199,2017-10-10,57.9875,699255,209572,1121707,1611390,3641924,9774,3153,351,188,13466
1200,2017-10-11,57.8375,666899,215776,1134633,1585756,3603064,8962,4061,346,196,13565
1201,2017-10-12,57.6975,727798,191233,1143886,1680451,3743368,9757,3509,385,156,13807
1202,2017-10-13,57.16,828959,216950,1129473,1741482,3916864,10319,3687,370,185,14561
1203,2017-10-16,57.3175,818701,181803,1123754,1760652,3884910,10492,3437,409,161,14499
1204,2017-10-17,57.2925,815911,175040,1135190,1776061,3902202,10812,3116,405,149,14482
1205,2017-10-18,57.425,767815,191554,1143713,1719974,3823056,10136,3598,381,164,14279
1206,2017-10-19,57.2725,814402,172861,1160490,1802031,3949784,11495,2567,399,147,14608
1207,2017-10-20,57.4825,783933,153450,1196010,1826493,3959886,10911,2500,390,149,13950
1208,2017-10-23,57.55,775659,186743,1188365,1777281,3928048,11022,2611,382,161,14176
1209,2017-10-24,57.62,798532,157554,1186168,1827146,3969400,10913,2435,391,149,13888
1210,2017-10-25,57.745,815493,134835,1191822,1872480,4014630,10956,2294,397,152,13799
1211,2017-10-26,57.855,776606,173907,1185988,1788687,3925188,10557,2562,366,172,13657
1212,2017-10-27,58.06,744339,180419,1119199,1683119,3727076,9875,2436,409,141,12861
1213,2017-10-30,57.9725,712868,182468,1119058,1649458,3663852,10127,2787,365,169,13448
1214,2017-10-31,58.32,719990,170768,1115982,1665204,3671944,9826,2761,422,137,13146
1215,2017-11-01,58.29,690876,172668,1156438,1674646,3694628,10047,2587,390,176,13200
1216,2017-11-02,58.1625,726469,150882,1111200,1686787,3675338,10199,2331,428,142,13100
1217,2017-11-03,59.08,669301,230548,1197903,1636656,3734408,9301,3348,443,144,13236
1218,2017-11-07,59.365,671856,199330,1204256,1676782,3752224,9368,2642,388,143,12541
1219,2017-11-08,59.2275,686222,204938,1242705,1723989,3857854,9570,2769,404,146,12889
1220,2017-11-09,59.29,624777,207231,1333009,1750555,3915572,9325,2952,403,148,12828
1221,2017-11-10,59.22,538939,277279,1451647,1713307,3981172,8253,4082,401,175,12911
1222,2017-11-13,59.35,618725,210434,1298007,1706298,3833464,9361,3065,416,158,13000
1223,2017-11-14,60.2375,621137,219302,1312282,1714117,3866838,9366,3157,416,156,13095
1224,2017-11-15,60.215,572262,237099,1350375,1685538,3845274,8836,3308,393,160,12697
1225,2017-11-16,59.6775,576068,217771,1312459,1670756,3777054,8854,3357,382,184,12777
1226,2017-11-17,59.08,531297,208919,1315949,1638327,3694492,8519,3759,373,197,12848
1227,2017-11-20,59.345,594135,174540,1280361,1699956,3748992,9464,3280,391,171,13306
1228,2017-11-21,59.1775,564686,217171,1384912,1732427,3899196,8879,3590,369,189,13027
1229,2017-11-22,58.485,589775,215183,1361796,1736388,3903142,9175,3915,373,214,13677
1230,2017-11-23,58.45,638380,194720,1420720,1864380,4118200,9748,3756,372,211,14087
1231,2017-11-24,58.37,646774,182278,1417243,1881739,4128034,9848,3435,377,194,13854
1232,2017-11-27,58.4975,677787,182924,1399278,1894141,4154130,10053,3683,393,195,14324
1233,2017-11-28,58.36,707617,151958,1373207,1928866,4161648,10497,3167,393,167,14224
1234,2017-11-29,58.62,752289,124149,1348765,1976905,4202108,10928,2789,443,149,14309
1235,2017-11-30,58.45,787578,140635,1342107,1989050,4259370,11185,2631,404,160,14380
1236,2017-12-01,58.88,790230,105518,1327921,2012633,4236302,11154,2177,433,146,13910
1237,2017-12-04,58.8075,737560,133031,1318282,1922811,4111684,10968,2319,428,153,13868
1238,2017-12-05,58.75,761045,141459,1311678,1931264,4145446,11099,2424,434,158,14115
1239,2017-12-06,59.23,817430,146622,1295017,1965825,4224894,11255,2401,459,131,14246
1240,2017-12-07,59.1775,763203,156232,1362753,1969724,4251912,10696,2629,445,131,13901
1241,2017-12-08,59.13,726287,156439,1389035,1958883,4230644,10137,2624,396,139,13296
1242,2017-12-11,59.005,711482,170276,1436580,1977786,4296124,9912,2947,389,158,13406
1243,2017-12-12,59.285,662606,205672,1457455,1914389,4240122,9018,3589,383,161,13151
1244,2017-12-13,58.6125,690995,216750,1465565,1939810,4313120,9616,3523,366,173,13678
1245,2017-12-14,58.76,714805,195667,1445644,1964782,4320898,9548,3396,363,171,13478
1246,2017-12-15,58.8,702529,210644,1456700,1948585,4318458,9185,3576,373,161,13295
1247,2017-12-18,58.6625,728038,247139,1482399,1963298,4420874,9183,3929,351,179,13642
1248,2017-12-19,58.7625,768534,200026,1469618,2038126,4476304,9517,3086,366,171,13140
1249,2017-12-20,58.71,739318,193231,1629380,2175467,4737396,9001,3190,361,168,12720
1250,2017-12-21,58.4625,561651,197668,1293670,1657653,3710642,6439,2972,283,135,9829
1251,2017-12-22,58.375,596557,209708,1302172,1689021,3797458,6921,3085,295,138,10439
1252,2017-12-25,57.9625,665924,238474,1309155,1736605,3950158,7760,3077,297,137,11271
1253,2017-12-26,57.62,693835,233222,1371893,1832506,4131456,7214,3119,294,145,10772
1254,2017-12-27,57.745,746969,155507,1414268,2005730,4322474,8071,2406,316,112,10905
1255,2017-12-28,57.5025,748605,170030,1415669,1994244,4328548,7814,2837,297,133,11081
1256,2017-12-29,57.63,759436,140085,1443537,2062888,4405946,7785,2126,293,108,10312
1257,2018-01-03,57.22,738134,186295,1466208,2018047,4408684,7606,2925,290,125,10946
1258,2018-01-04,56.84,739676,176480,1467066,2030262,4413484,7586,2850,291,133,10860
1259,2018-01-05,56.9825,750163,146824,1467412,2070751,4435150,7870,2622,307,112,10911
1260,2018-01-09,56.995,746339,150397,1464326,2060268,4421330,7907,2848,306,128,11189
1261,2018-01-10,57.0325,788119,157091,1472253,2103281,4520744,8346,2651,316,124,11437
1262,2018-01-11,56.4275,777469,228143,1480580,2029906,4516098,8121,3262,308,142,11833
1263,2018-01-12,56.65,794831,185821,1512605,2121615,4614872,8675,2846,313,138,11972
1264,2018-01-15,56.32,797208,181813,1504760,2120155,4603936,8302,3114,311,134,11861
1265,2018-01-16,56.53,818402,152572,1522902,2188732,4682608,8815,2824,335,117,12091
1266,2018-01-17,56.7525,913001,124580,1511442,2299863,4848886,10557,2212,350,114,13233
1267,2018-01-18,56.525,678670,178733,1727086,2227023,4811512,10175,2840,341,148,13504
1268,2018-01-19,56.72,685204,134130,1718919,2269993,4808246,10640,2361,353,122,13476
1269,2018-01-22,56.495,675372,163449,1731427,2243350,4813598,10373,2657,338,137,13505
1270,2018-01-23,56.35,648802,182888,1744230,2210144,4786064,8921,3870,329,142,13262
1271,2018-01-24,56.1725,640378,244476,1755720,2151622,4792196,8657,4193,329,150,13329
1272,2018-01-25,55.9275,673750,239169,1737044,2171625,4821588,8731,4154,318,160,13363
1273,2018-01-26,56.275,699067,153406,1691709,2237370,4781552,9292,3294,350,130,13066
1274,2018-01-29,56.32,784530,90022,1655129,2349637,4879318,11205,2015,363,111,13694
1275,2018-01-30,56.385,710100,131874,1635121,2213347,4690442,10261,2600,322,144,13327
1276,2018-01-31,56.2075,741415,102449,1641363,2280329,4765556,10824,2221,354,108,13507
1277,2018-02-01,55.92,734006,101373,1679527,2312160,4827066,10619,2208,354,116,13297
1278,2018-02-02,56.55,749205,104391,1678900,2323714,4856210,10575,2122,362,109,13168
1279,2018-02-05,57.195,745132,99399,1632352,2278085,4754968,11093,1689,367,106,13255
1280,2018-02-06,56.855,705835,127725,1599812,2177922,4611294,10585,1931,355,108,12979
1281,2018-02-07,57.61,718929,105800,1586697,2199826,4611252,10668,1816,357,114,12955
1282,2018-02-08,58.4225,662924,166816,1580649,2076757,4487146,9951,2434,358,114,12857
1283,2018-02-09,58.4,644501,163327,1621814,2102988,4532630,9455,2458,344,116,12373
1284,2018-02-12,57.83,600518,173891,1619185,2045812,4439406,9156,2448,339,128,12071
1285,2018-02-13,57.63,599512,174425,1597097,2022184,4393218,8625,3054,321,140,12140
1286,2018-02-14,56.71,559151,206761,1627228,1979618,4372758,7885,3501,315,159,11860
1287,2018-02-15,56.3925,600170,153678,1642113,2088605,4484566,8780,3255,314,155,12504
1288,2018-02-16,56.3975,604807,182660,1645471,2067618,4500556,8836,3195,324,155,12510
1289,2018-02-19,56.46,636705,152074,1581968,2066599,4437346,9594,2620,326,135,12675
1290,2018-02-20,56.565,713927,157808,1578426,2134545,4584706,10355,2235,358,113,13061
1291,2018-02-21,56.76,665945,155933,1574392,2084404,4480674,9961,2418,332,137,12848
1292,2018-02-22,56.5175,670921,155924,1544110,2059107,4430062,9734,2429,336,135,12634
1293,2018-02-26,55.705,648493,178834,1593449,2063108,4483884,8665,3759,318,147,12889
1294,2018-02-27,56.275,688593,185105,1593800,2097288,4564786,9099,3379,333,135,12946
1295,2018-02-28,56.3325,680485,225017,1541879,1997347,4444728,8900,3889,332,150,13271
1296,2018-03-01,56.8225,723314,197941,1475080,2000453,4396788,10323,2109,368,110,12910
1297,2018-03-02,56.815,684400,217018,1470516,1937898,4309832,9800,2143,367,106,12416
1298,2018-03-05,56.42,631750,229473,1518413,1920690,4300326,9588,2448,350,112,12498
1299,2018-03-06,56.67,594457,296533,1576294,1874218,4341502,7987,4425,303,168,12883
1300,2018-03-07,56.79,601994,249586,1508296,1860704,4220580,8110,3844,338,133,12425
1301,2018-03-09,56.66,623164,260746,1502543,1864961,4251414,8775,3107,325,142,12349
1302,2018-03-12,56.88,605068,260372,1505340,1850036,4220816,8840,3086,327,147,12400
1303,2018-03-13,57.02,596595,257809,1422653,1761439,4038496,8475,3025,321,152,11973
1304,2018-03-14,57.1225,675799,234399,969805,1411205,3291208,9296,2165,343,117,11921
1305,2018-03-15,57.46,559389,215024,820832,1165197,2760442,7315,1843,293,91,9542
1306,2018-03-16,57.49,539436,231759,835283,1142960,2749438,7500,2334,297,97,10228
1307,2018-03-19,57.84,551516,235558,835393,1151351,2773818,7552,2594,295,111,10552
1308,2018-03-20,57.53,521313,260016,874685,1135982,2791996,7176,2981,258,141,10556
1309,2018-03-21,56.88,463957,322761,880144,1021340,2688202,5540,4791,240,166,10737
1310,2018-03-22,57.245,524246,278978,829497,1074765,2707486,6441,3937,268,140,10786
1311,2018-03-23,57.29,504233,284515,833350,1053068,2675166,6103,4231,274,144,10752
1312,2018-03-26,57.1625,608295,216076,790415,1182634,2797420,7753,2175,277,136,10341
1313,2018-03-27,57.5125,615580,236398,803491,1182673,2838142,8282,2088,285,133,10788
1314,2018-03-28,57.7225,637958,219184,791731,1210505,2859378,8417,2264,312,114,11107
1315,2018-03-29,57.2575,568754,257583,839034,1150205,2815576,7741,2738,271,148,10898
1316,2018-03-30,57.145,588307,228577,815093,1174823,2806800,8074,2503,272,137,10986
1317,2018-04-02,57.4825,625368,235433,832013,1221948,2914762,8249,2395,303,126,11073
1318,2018-04-03,57.57,611968,230785,800914,1182097,2825764,8331,2301,304,117,11053
1319,2018-04-04,57.445,590622,230069,805701,1166254,2792646,7865,2545,308,118,10836
1320,2018-04-05,57.71,547740,228926,817846,1136660,2731172,7851,2436,302,120,10709
1321,2018-04-06,58.175,606586,248744,805509,1163351,2824190,7898,2672,311,126,11007
1322,2018-04-09,60.66,502374,302881,857084,1056577,2718916,7065,3552,286,129,11032
1323,2018-04-10,63.0225,366977,232696,915351,1049632,2564656,6078,3006,255,142,9481
1324,2018-04-11,62.59,359996,218465,900188,1041719,2520368,6425,3076,251,153,9905
1325,2018-04-12,61.99,322926,183816,854376,993486,2354604,6148,3384,216,177,9925
1326,2018-04-13,62.05,347880,150895,771663,968648,2239086,6650,2750,246,149,9795
1327,2018-04-16,61.165,348625,146999,784531,986157,2266312,6989,2668,242,140,10039
1328,2018-04-17,61.5575,299298,175493,835718,959523,2270032,6205,3268,219,166,9858
1329,2018-04-18,60.85,271034,213779,884560,941815,2311188,5714,3739,206,187,9846
1330,2018-04-19,60.8925,274898,153514,769081,890465,2087958,6075,3391,225,160,9851
1331,2018-04-20,61.4,314366,126880,733815,921301,2096362,6470,3222,249,159,10100
1332,2018-04-23,61.805,375898,143014,714632,947516,2181060,7302,2627,276,138,10343
1333,2018-04-24,61.62,333256,179601,779638,933293,2225788,6767,3230,237,161,10395
1334,2018-04-25,62.365,405936,174372,703092,934656,2218056,7370,2912,274,132,10688
1335,2018-04-26,62.72,387270,185748,724213,925735,2222966,6874,3113,266,139,10392
1336,2018-04-27,62.155,339124,185943,750109,903290,2178466,6451,3247,231,166,10095
1337,2018-04-28,62.27,298042,168643,771863,901262,2139810,5604,3922,245,149,9920
1338,2018-04-30,62.9675,349885,163850,719122,905157,2138014,6813,2873,277,133,10096
1339,2018-05-02,64.02,355160,210632,750207,894735,2210734,6534,3484,272,135,10425
1340,2018-05-03,63.025,315328,200497,780324,895155,2191304,6535,3462,227,175,10399
1341,2018-05-04,62.505,239340,243483,908182,904039,2295044,4565,4981,211,186,9943
1342,2018-05-07,62.9325,249099,220595,858393,886897,2214984,4686,5119,222,180,10207
1343,2018-05-08,63.225,337385,191583,757959,903761,2190688,6438,3580,261,148,10427
1344,2018-05-10,61.71,282715,217997,836770,901488,2238970,5277,4507,220,196,10200
1345,2018-05-11,61.93,270720,193971,842115,918864,2225670,5539,4363,218,189,10309
1346,2018-05-14,61.85,274014,207470,835503,902047,2219034,5453,4451,222,181,10307
1347,2018-05-15,62.3175,408731,161015,741569,989285,2300600,7016,2773,268,151,10208
1348,2018-05-16,61.73,336805,178623,786829,945011,2247268,6618,3228,258,151,10255
1349,2018-05-17,62.185,307501,187921,825604,945184,2266210,5989,3591,250,154,9984
1350,2018-05-18,62.2575,371735,169905,782248,984078,2307966,6848,2686,269,144,9947
1351,2018-05-21,61.6,316467,219001,853050,950516,2339034,5545,4055,229,176,10005
1352,2018-05-22,61.21,295816,246883,893158,942091,2377948,5425,4822,233,187,10667
1353,2018-05-23,61.33,301355,208271,840175,933259,2283060,5594,4284,255,149,10282
1354,2018-05-24,61.6,305875,199692,816292,922475,2244334,5808,4092,256,161,10317
1355,2018-05-25,62.2875,382483,169597,734919,947805,2234804,7351,2557,279,128,10315
1356,2018-05-28,62.32,373825,178862,747871,942834,2243392,7237,2887,277,132,10533
1357,2018-05-29,62.815,318150,186316,818332,950166,2272964,6910,3037,261,148,10356
1358,2018-05-30,62.075,277211,268219,898875,907867,2352172,5437,4484,216,190,10327
1359,2018-05-31,62.405,298242,231725,835549,902066,2267582,5627,4344,230,172,10373
1360,2018-06-01,62.1925,300130,253324,864765,911571,2329790,5325,4600,218,184,10327
1361,2018-06-04,62.0575,302905,240167,841074,903812,2287958,5584,4464,228,172,10448
1362,2018-06-05,62.15,410091,186398,809265,1032958,2438712,6965,3084,264,137,10450
1363,2018-06-06,61.7675,350834,216700,824162,958296,2349992,6525,3518,235,166,10444
1364,2018-06-07,62.4175,350639,205212,823518,968945,2348314,5791,4132,256,151,10330
1365,2018-06-08,62.31,344884,169780,829988,1005092,2349744,6801,2783,257,152,9993
1366,2018-06-09,62.525,353762,165625,816235,1004372,2339994,6981,2588,263,144,9976
1367,2018-06-11,62.8175,376366,160309,814820,1030877,2382372,6961,2577,270,136,9944
1368,2018-06-13,62.535,373986,196003,817018,995001,2382008,7151,2901,250,159,10461
1369,2018-06-14,62.63,329062,203998,818920,943984,2295964,5988,3830,237,173,10228
1370,2018-06-15,63.1975,358268,222782,820225,955711,2356986,6951,2842,274,141,10208
1371,2018-06-18,63.4525,362095,257469,829301,933927,2382792,6809,3101,279,137,10326
1372,2018-06-19,63.875,330651,288373,865010,907288,2391322,6281,3461,261,144,10147
1373,2018-06-20,63.69,278585,285787,914632,907430,2386434,5889,3549,228,184,9850
1374,2018-06-21,63.715,239127,208307,663047,693867,1804348,4848,2696,215,113,7872
1375,2018-06-22,62.895,257174,216807,692757,733124,1899862,4533,3898,201,145,8777
1376,2018-06-25,62.7825,281474,190520,649889,740843,1862726,4865,3791,201,167,9024
1377,2018-06-26,63.0275,373417,147630,557421,783208,1861676,6472,2303,233,139,9147
1378,2018-06-27,63.23,299630,183626,627909,743913,1855078,5865,2704,216,156,8941
1379,2018-06-28,62.8,310419,210530,647989,747878,1916816,6012,2843,217,149,9221
1380,2018-06-29,62.77,272908,220040,700540,753408,1946896,4858,3911,199,158,9126
1381,2018-07-02,63.43,329947,179589,653511,803869,1966916,6008,2776,223,119,9126
1382,2018-07-03,63.145,314275,164834,672729,822170,1974008,6237,2376,218,143,8974
1383,2018-07-04,63.24,334180,153862,641171,821489,1950702,6406,2260,240,122,9028
1384,2018-07-05,63.115,252278,292986,834741,794033,2174038,4576,4236,189,167,9168
1385,2018-07-06,62.9725,279498,273134,776713,783077,2112422,4875,3988,204,157,9224
1386,2018-07-09,62.485,291974,297843,791047,785178,2166042,5122,4156,190,175,9643
1387,2018-07-10,61.735,323092,285058,739500,777534,2125184,5564,3817,196,165,9742
1388,2018-07-11,62.3575,345907,237770,684691,792828,2061196,5635,3555,209,156,9555
1389,2018-07-12,62.255,324125,214244,667918,777799,1984086,5754,3501,227,134,9616
1390,2018-07-13,62.56,333687,215059,643225,761853,1953824,5544,3507,220,142,9413
1391,2018-07-16,62.33,351420,179428,597843,769835,1898526,6168,3057,230,116,9571
1392,2018-07-17,62.6,404129,131898,553570,825801,1915398,7494,1967,269,96,9826
1393,2018-07-18,62.9625,399977,139026,574995,835946,1949944,6883,2445,261,103,9692
1394,2018-07-19,63.6625,369878,160226,605156,814808,1950068,6477,2807,254,121,9659
1395,2018-07-20,63.515,280494,165175,698752,814071,1958492,5745,3107,224,141,9217
1396,2018-07-23,63.0675,273542,218437,718550,773655,1984184,4930,4056,202,163,9351
1397,2018-07-24,63.325,267107,238025,714818,743900,1963850,4867,4127,210,163,9367
1398,2018-07-25,62.82,280030,194252,668406,754184,1896872,5019,3897,210,144,9270
1399,2018-07-26,62.955,318623,173706,637372,782289,1911990,5364,3728,234,131,9457
1400,2018-07-27,62.7975,317066,238074,683108,762100,2000348,5406,3970,206,167,9749
1401,2018-07-30,62.2375,352101,244589,667565,775077,2039332,6009,3961,216,164,10350
1402,2018-07-31,62.5025,391515,157860,629510,863165,2042050,6588,3405,229,146,10368
1403,2018-08-01,63.045,433490,125676,606080,913894,2079140,7489,2335,259,114,10197
1404,2018-08-02,63.405,431778,141420,578479,868837,2020514,7123,2540,250,126,10039
1405,2018-08-03,63.3375,345913,166775,650654,829792,1993134,6531,3168,229,139,10067
1406,2018-08-06,63.74,432849,164842,575615,843622,2016928,7087,2920,258,119,10384
1407,2018-08-07,63.49,346024,192183,659249,813090,2010546,6433,3464,223,153,10273
1408,2018-08-08,65.5475,422949,244281,712616,891284,2271130,6652,3518,253,135,10558
1409,2018-08-09,66.65,415600,293831,798624,920393,2428448,6410,4056,226,157,10849
1410,2018-08-10,67.72,398258,325577,857893,930574,2512302,6184,4377,242,149,10952
1411,2018-08-13,67.8,341610,355279,947777,934108,2578774,6061,4889,205,172,11327
1412,2018-08-14,66.34,332342,310349,925226,947219,2515136,5512,4965,190,180,10847
1413,2018-08-15,67.29,405732,281577,836036,960191,2483536,6519,4059,240,140,10958
1414,2018-08-16,66.8425,355518,264872,822519,913165,2356074,6211,4414,207,172,11004
1415,2018-08-17,67.03,426697,242791,769352,953258,2392098,6844,3992,230,153,11219
1416,2018-08-20,67.1075,371745,275093,841589,938241,2426668,6508,4350,211,170,11239
1417,2018-08-21,67.275,459333,251601,782695,990427,2484056,7142,3907,235,142,11426
1418,2018-08-22,68.03,492279,273949,815468,1033798,2615494,7629,4000,266,133,12028
1419,2018-08-23,68.19,392780,304069,813492,902203,2412544,6382,4404,223,146,11155
1420,2018-08-24,67.1,372905,317664,859222,914463,2464254,6136,4532,206,171,11045
1421,2018-08-27,67.52,352532,321828,891659,922363,2488382,6055,4757,211,177,11200
1422,2018-08-28,67.87,432421,273632,822191,980980,2509224,6858,4054,235,156,11303
1423,2018-08-29,67.94,442365,298826,853547,997086,2591824,6932,4167,252,155,11506
1424,2018-08-30,68.2375,412254,289340,861158,984072,2546824,6761,4172,234,171,11338
1425,2018-08-31,67.55,396284,356507,974422,1014199,2741412,6115,4863,216,188,11382
1426,2018-09-03,68.12,418830,313736,945804,1050898,2729268,6680,4493,250,159,11582
1427,2018-09-04,68.11,419126,302233,923969,1040862,2686190,6826,4153,252,147,11378
1428,2018-09-05,68.25,432430,303003,901309,1030736,2667478,7233,4173,252,154,11812
1429,2018-09-06,69.255,493161,333603,805774,965332,2597870,7285,4501,267,150,12203
1430,2018-09-07,69.9125,486469,310932,764245,939782,2501428,7382,4245,267,147,12041
1431,2018-09-10,70.565,515910,329247,795972,982635,2623764,7673,4469,279,146,12567
1432,2018-09-11,69.41,433338,346155,909004,996187,2684684,6866,4655,229,181,11931
1433,2018-09-12,69.0325,407377,358214,934777,983940,2684308,6423,4857,227,181,11688
1434,2018-09-13,68.25,427783,291960,811265,947088,2478096,6826,4250,234,174,11484
1435,2018-09-14,68.0525,454411,269067,835887,1021231,2580596,6954,4322,231,180,11687
1436,2018-09-17,68.0625,452312,262287,844632,1034657,2593888,7047,4341,240,172,11800
1437,2018-09-18,67.3725,418862,271219,885473,1033116,2608670,6087,5296,212,190,11785
1438,2018-09-19,66.83,449496,268486,820797,1001807,2540586,6169,5039,220,169,11597
1439,2018-09-20,66.26,431924,170771,629936,891089,2123720,6105,3483,198,142,9928
1440,2018-09-21,66.41,495981,130533,607686,973134,2207334,7277,2954,229,128,10588
1441,2018-09-24,65.835,484694,220164,623937,888467,2217262,6625,4431,204,163,11423
1442,2018-09-25,65.8925,523261,172325,584104,935040,2214730,7358,4096,219,146,11819
1443,2018-09-26,65.8,620349,126759,570166,1063756,2381030,9067,3055,257,122,12501
1444,2018-09-27,65.6225,530400,222484,612278,920194,2285356,7710,4091,210,173,12184
1445,2018-09-28,65.535,523963,200145,599633,923451,2247192,7784,3666,214,130,11794
1446,2018-10-01,65.0,506306,190964,609787,925129,2232186,7728,3800,232,138,11898
1447,2018-10-02,65.5,526435,167317,586962,946080,2226794,8004,3566,248,124,11942
1448,2018-10-03,65.8625,539294,155888,620132,1003538,2318852,9016,3114,255,119,12504
1449,2018-10-04,67.0175,546051,139027,647013,1054037,2386128,9542,2310,264,120,12236
1450,2018-10-05,66.5975,475379,173831,687617,989165,2325992,8962,2793,220,164,12139
1451,2018-10-08,66.5575,487843,183063,705796,1010576,2387278,8873,2634,245,138,11890
1452,2018-10-09,66.25,465202,178689,696070,982583,2322544,8108,3456,234,153,11951
1453,2018-10-10,66.9,439762,213193,683852,910421,2247228,7462,4140,212,159,11973
1454,2018-10-11,66.27,474615,223245,676989,928359,2303208,7570,4355,207,183,12315
1455,2018-10-12,66.1175,496080,179892,668305,984493,2328770,7902,3760,231,150,12043
1456,2018-10-15,65.65,504887,223097,648772,930562,2307318,8042,4286,220,175,12723
1457,2018-10-16,65.3075,495249,250566,675434,920117,2341366,7836,4590,229,183,12838
1458,2018-10-17,65.4975,549081,145295,678953,1082739,2456068,8687,3758,256,148,12849
1459,2018-10-18,65.82,637714,94117,668668,1212265,2612764,10289,2143,271,132,12835
1460,2018-10-19,65.49,590061,163662,660844,1087243,2501810,9296,2856,233,148,12533
1461,2018-10-22,65.25,552912,227744,657475,982643,2420774,8312,4393,214,191,13110
1462,2018-10-23,65.5125,635225,146824,654783,1143184,2580016,9498,3234,259,143,13134
1463,2018-10-24,65.685,582966,129501,624366,1077831,2414664,9326,2757,252,163,12498
1464,2018-10-25,65.5925,633461,86563,649251,1196149,2565424,10334,2088,269,130,12821
1465,2018-10-26,65.72,661370,87176,701137,1275331,2725014,10416,1903,286,119,12724
1466,2018-10-29,65.85,581226,207717,700109,1073618,2562670,8811,3545,229,172,12757
1467,2018-10-30,65.56,603404,155081,695433,1143756,2597674,9317,3388,239,163,13107
1468,2018-10-31,65.875,633170,121919,696956,1208207,2660252,9463,2954,271,140,12828
1469,2018-11-01,65.72,604730,159896,718282,1163116,2646024,9398,3316,259,157,13130
1470,2018-11-02,66.2025,700492,76015,680268,1304745,2761520,10374,1845,289,131,12639
1471,2018-11-06,66.11,642076,100448,697975,1239603,2680102,10157,2244,253,160,12814
1472,2018-11-07,66.32,651477,98261,685465,1238681,2673884,10293,2051,259,156,12759
1473,2018-11-08,66.9025,715732,97038,696069,1314763,2823602,11028,1935,295,138,13396
1474,2018-11-09,68.005,685113,117273,708059,1275899,2786344,9975,2340,313,124,12752
1475,2018-11-12,67.845,618712,122033,729221,1225900,2695866,9536,2475,278,131,12420
1476,2018-11-13,68.13,682058,139828,740854,1283084,2845824,9595,2437,299,141,12472
1477,2018-11-14,67.02,531242,215353,771770,1087659,2606024,8157,3666,262,177,12262
1478,2018-11-15,65.8975,478269,184146,809125,1103248,2574788,7722,3828,261,176,11987
1479,2018-11-16,65.98,520608,143493,815903,1193018,2673022,8345,3444,275,162,12226
1480,2018-11-19,65.55,536131,127296,827889,1236724,2728040,8560,3272,268,140,12240
1481,2018-11-20,66.165,579449,101929,816736,1294256,2792370,9492,2739,316,129,12676
1482,2018-11-21,65.66,583682,115307,797728,1266103,2762820,9338,2664,300,146,12448
1483,2018-11-22,65.62,543199,174950,804865,1173114,2696128,9004,3532,278,162,12976
1484,2018-11-23,66.1925,688681,70826,798750,1416605,2974862,11109,1595,340,119,13163
1485,2018-11-26,67.1025,681302,78866,804088,1406524,2970780,10466,1969,333,112,12880
1486,2018-11-27,67.1075,601620,96387,834881,1340114,2873002,9660,2346,281,152,12439
1487,2018-11-28,66.955,618424,95437,839307,1362294,2915462,9836,2404,316,127,12683
1488,2018-11-29,66.21,511251,173373,901876,1239754,2826254,7676,4245,255,171,12347
1489,2018-11-30,66.95,558842,107761,872774,1323855,2863232,8338,3413,294,135,12180
1490,2018-12-03,66.5275,490251,135861,885540,1239930,2751582,7102,4083,272,149,11606
1491,2018-12-04,66.82,496318,121451,885123,1259990,2762882,7400,3823,270,149,11642
1492,2018-12-05,66.57,519004,129239,870271,1260036,2778550,8318,3601,333,150,12402
1493,2018-12-06,66.8675,625651,90732,864199,1399118,2979700,10211,2114,357,128,12810
1494,2018-12-07,66.395,536233,182866,867674,1221041,2807814,8214,3709,308,165,12396
1495,2018-12-10,66.6425,561047,114252,857793,1304588,2837680,8401,3392,339,137,12269
1496,2018-12-11,66.3525,527221,156046,854254,1225429,2762950,7904,3770,315,170,12159
1497,2018-12-12,66.3825,543314,166656,857245,1233903,2801118,8163,3784,311,164,12422
1498,2018-12-13,66.235,566381,140015,845704,1272070,2824170,8291,3577,318,148,12334
1499,2018-12-14,66.76,713675,91780,860471,1482366,3148292,10167,2373,353,126,13019
1500,2018-12-14,66.76,713675,91780,860471,1482366,3148292,10167,2373,353,126,13019
1501,2018-12-17,66.78,672729,96070,857941,1434600,3061340,10152,2254,335,146,12887
1502,2018-12-18,67.2825,699501,99546,800958,1400913,3000918,10323,2067,356,119,12865
1503,2018-12-19,67.46,648438,122725,809931,1335644,2916738,9205,2449,346,115,12115
1504,2018-12-20,68.2925,529101,109023,628042,1048120,2314286,7333,2359,302,91,10085
1505,2018-12-21,68.84,547793,122425,722777,1148145,2541140,7504,2754,307,92,10657
1506,2018-12-24,68.5825,578410,128165,732061,1182306,2620942,7843,2713,301,104,10961
1507,2018-12-25,68.665,613160,113599,727637,1227198,2681594,8432,2434,324,94,11284
1508,2018-12-26,68.695,635233,124369,723841,1234705,2718148,8201,2827,327,99,11454
1509,2018-12-27,69.56,594917,153544,725957,1167330,2641748,7794,3296,305,123,11518
1510,2018-12-28,69.5175,543988,137125,713189,1120052,2514354,7570,3000,295,114,10979
1511,2018-12-29,69.8175,513487,137320,737462,1113629,2501898,7393,3042,306,103,10844
1512,2019-01-03,68.64,495046,152387,752916,1095575,2495924,7082,3583,284,133,11082
1513,2019-01-04,67.74,513385,134988,671794,1050191,2370358,7204,3390,292,114,11000
1514,2019-01-08,66.885,534128,122767,667668,1079029,2403592,7911,3341,307,120,11679
1515,2019-01-09,66.745,580272,109831,680891,1151332,2522326,8887,3242,332,102,12563
1516,2019-01-10,66.91,685629,80301,699811,1305139,2770880,10598,2322,350,94,13364
1517,2019-01-11,66.875,700660,75233,679273,1304700,2759866,11022,2250,359,90,13721
1518,2019-01-14,67.075,705925,95478,661464,1271911,2734778,11310,2374,361,96,14141
1519,2019-01-15,66.96,693413,136978,656040,1212475,2698906,10950,2919,348,108,14325
1520,2019-01-16,66.3675,670361,241527,691403,1120237,2723528,9770,4279,319,144,14512
1521,2019-01-17,66.37,571503,164021,790173,1197655,2723352,10139,3525,348,108,14120
1522,2019-01-18,66.275,487619,211391,803876,1080104,2582990,9459,4137,322,132,14050
1523,2019-01-21,66.39,498032,164664,788520,1121888,2573104,9937,3652,344,118,14051
1524,2019-01-22,66.535,513136,160825,791338,1143649,2608948,10515,3332,340,118,14305
1525,2019-01-23,66.0725,497154,244128,803252,1056278,2600812,10141,4048,323,137,14649
1526,2019-01-24,65.7775,527862,256433,785930,1057359,2627584,9940,4318,333,137,14728
1527,2019-01-25,66.0,576001,131155,737763,1182609,2627528,10530,3248,347,111,14236
1528,2019-01-28,66.26,613830,131989,754709,1236550,2737078,11342,3001,369,96,14808
1529,2019-01-29,66.05,636159,118368,687604,1205395,2647526,11986,2292,355,105,14738
1530,2019-01-30,65.505,598472,183779,702515,1117208,2601974,10942,3567,339,119,14967
1531,2019-01-31,65.4,608831,196022,727345,1140154,2672352,10908,3897,332,134,15271
1532,2019-02-01,65.505,610194,150691,724416,1183919,2669220,10954,3528,339,119,14940
1533,2019-02-04,65.59,626730,114052,714238,1226916,2681936,11698,3070,354,104,15226
1534,2019-02-05,65.62,566704,158957,692334,1100081,2518076,10729,3803,325,128,14985
1535,2019-02-06,65.87,750421,89218,680616,1341819,2862074,13260,1786,367,90,15503
1536,2019-02-07,65.9075,722179,64238,682162,1340103,2808682,13067,1819,369,85,15340
1537,2019-02-08,65.81,635770,161277,727755,1202248,2727050,11568,3218,345,120,15251
1538,2019-02-11,65.85,630587,146636,706818,1190769,2674810,11669,3439,337,115,15560
1539,2019-02-12,65.885,620186,202277,723663,1141572,2687698,11606,3712,329,129,15776
1540,2019-02-13,66.515,653751,114004,720384,1260131,2748270,12329,2659,362,98,15448
1541,2019-02-14,66.645,688755,95424,686349,1279680,2750208,12491,2160,390,82,15123
1542,2019-02-15,66.3,606719,107726,706799,1205792,2627036,11798,2353,366,104,14621
1543,2019-02-18,66.28,575898,161875,796912,1210935,2745620,10862,3711,348,124,15045
1544,2019-02-19,65.7625,566483,151097,757810,1173196,2648586,11400,3715,365,116,15596
1545,2019-02-20,65.6325,594064,180793,737309,1150580,2662746,11505,3915,333,133,15886
1546,2019-02-21,65.57,629842,165783,690763,1154822,2641210,12076,3863,332,136,16407
1547,2019-02-22,65.3925,642988,158426,692070,1176632,2670116,12426,3667,324,131,16548
1548,2019-02-25,65.49,655342,110616,719314,1264040,2749312,12623,3353,354,110,16440
1549,2019-02-26,65.7,794313,70021,736019,1460311,3060664,14536,1587,394,85,16602
1550,2019-02-27,65.79,786542,72438,725206,1439310,3023496,14289,1610,395,86,16380
1551,2019-02-28,65.905,712943,95199,715170,1332914,2856226,13691,2072,375,93,16231
1552,2019-03-01,65.94,675301,202904,820496,1292893,2991594,12245,3476,359,114,16194
1553,2019-03-04,65.74,700185,205752,926114,1420547,3252598,12535,3432,342,134,16443
1554,2019-03-05,65.75,726019,152410,897587,1471196,3247212,12735,2921,342,133,16131
1555,2019-03-06,65.98,872601,82344,869960,1660217,3485122,14350,1660,381,92,16483
1556,2019-03-07,66.2825,813191,78180,861183,1596194,3348748,13599,1688,377,92,15756
1557,2019-03-11,65.97,774790,102993,853704,1525501,3256988,13774,1895,359,107,16135
1558,2019-03-12,65.635,645199,221559,1070693,1494333,3431784,12067,3903,334,138,16442
1559,2019-03-13,65.4,699836,257594,1046338,1488580,3492348,12602,3955,337,138,17032
1560,2019-03-14,65.5125,714297,162259,974823,1526861,3378240,13290,3008,358,118,16774
1561,2019-03-15,64.815,709489,250820,1015539,1474208,3450056,12834,3834,334,133,17135
1562,2019-03-18,64.365,689717,263446,974701,1400972,3328836,12365,4128,325,142,16960
1563,2019-03-19,64.39,679009,190411,988917,1477515,3335852,12680,3361,347,109,16497
1564,2019-03-20,63.8675,664119,206248,1059122,1516993,3446482,12227,3656,329,121,16333
1565,2019-03-21,63.87,474276,202467,794142,1065951,2536836,9081,3469,280,117,12947
1566,2019-03-22,64.66,568404,112896,780580,1236088,2697968,10658,2535,327,88,13608
1567,2019-03-25,64.085,530836,158801,750765,1122800,2563202,10639,3189,293,124,14245
1568,2019-03-26,64.4,557486,99356,698609,1156739,2512190,11297,2401,326,91,14115
1569,2019-03-27,64.835,606617,104447,704442,1206612,2622118,11140,2677,341,80,14238
1570,2019-03-28,64.94,592029,112613,704392,1183808,2592842,10986,2844,344,82,14256
1571,2019-03-29,65.6375,516908,129711,738531,1125728,2510878,10137,3080,321,101,13639
1572,2019-04-01,65.1725,520604,93895,695451,1122160,2432110,11448,2268,348,91,14155
1573,2019-04-02,65.2975,509053,101575,714648,1122126,2447402,11586,2417,333,98,14434
1574,2019-04-03,65.24,554123,139088,711975,1127010,2532196,11287,2809,341,101,14538
1575,2019-04-04,65.475,613931,95765,625619,1143785,2479100,12144,2161,359,84,14748
1576,2019-04-05,65.34,542565,160156,649377,1031786,2383884,11372,2829,322,118,14641
1577,2019-04-08,64.8775,510630,248018,702260,964872,2425780,9698,4493,295,126,14612
1578,2019-04-09,64.92,500231,194191,619698,925738,2239858,9989,4035,285,133,14442
1579,2019-04-10,64.2925,519129,266120,640175,893184,2318608,9637,4637,278,147,14699
1580,2019-04-11,64.61,537918,164435,634459,1007942,2344754,10195,3647,305,111,14258
1581,2019-04-12,64.35,526622,242540,683779,967861,2420802,9948,4300,273,137,14658
1582,2019-04-15,64.26,545466,187363,677716,1035819,2446364,10435,3935,295,119,14784
1583,2019-04-16,64.09,572072,162854,660747,1069965,2465638,10744,3712,294,119,14869
1584,2019-04-17,63.845,579985,239262,705411,1046134,2570792,10539,4432,278,143,15392
1585,2019-04-18,63.8925,580117,169830,699525,1109812,2559284,10774,4048,280,132,15234
1586,2019-04-19,64.05,597298,161164,684302,1120436,2563200,10962,3827,298,120,15207
1587,2019-04-22,63.82,561764,197859,744446,1108351,2612420,10545,4143,288,117,15093
1588,2019-04-23,63.6875,554401,196335,750937,1109003,2610676,10694,4007,302,125,15128
1589,2019-04-24,64.3225,684813,91639,714238,1307412,2798102,12103,2651,333,92,15179
1590,2019-04-25,64.655,666524,90530,692183,1268177,2717414,12234,2197,346,89,14866
1591,2019-04-26,64.735,613371,81027,686809,1219153,2600360,11814,2130,324,101,14369
1592,2019-04-29,64.4575,598689,205692,719586,1112583,2636550,10212,4150,295,134,14791
1593,2019-04-30,64.6225,566210,165518,706997,1107689,2546414,10048,3988,295,122,14453
1594,2019-05-02,65.4375,620871,101181,671159,1190849,2584060,11518,2355,344,68,14285
1595,2019-05-03,65.0775,556215,140802,747240,1162653,2606910,10909,2655,305,108,13977
1596,2019-05-06,65.2275,598193,114645,727562,1211110,2651510,11803,2271,319,97,14490
1597,2019-05-07,65.4075,574261,141010,754809,1188060,2658140,10471,3213,310,113,14107
1598,2019-05-08,65.0725,588313,213327,758452,1133438,2693530,9977,4310,291,133,14711
1599,2019-05-10,65.075,668278,92627,740780,1316431,2818116,11704,2034,329,81,14148
1600,2019-05-13,65.43,624310,109214,740666,1255762,2729952,11443,2262,328,91,14124
1601,2019-05-14,64.97,563189,228981,787193,1121401,2700764,9892,4329,279,137,14637
1602,2019-05-15,64.65,549149,230269,793297,1112177,2684892,9726,4420,272,147,14565
1603,2019-05-16,64.65,550934,229677,795778,1117035,2693424,9691,4477,264,146,14578
1604,2019-05-17,64.7775,592527,149040,754975,1198462,2695004,10724,3279,308,103,14414
1605,2019-05-20,64.525,561700,217984,757485,1101201,2638370,9901,4421,271,139,14732
1606,2019-05-21,64.41,544132,234486,770940,1080586,2630144,9810,4282,282,133,14507
1607,2019-05-22,64.39,542711,264023,761791,1040479,2609004,9775,4365,272,148,14560
1608,2019-05-23,64.855,720526,81308,634588,1273806,2710228,12434,1594,331,78,14437
1609,2019-05-24,64.4725,636560,144738,643770,1135592,2560660,11182,2734,296,111,14323
1610,2019-05-27,64.4575,607076,198432,660055,1068699,2534262,10381,3897,291,127,14696
1611,2019-05-28,64.715,791706,85411,645655,1351950,2874722,12682,1578,337,75,14672
1612,2019-05-29,64.97,755592,101501,564275,1218366,2639734,11495,2098,326,81,14000
1613,2019-05-30,65.17,667292,98021,559100,1128371,2452784,11274,2238,289,101,13902
1614,2019-05-31,65.43,685624,93717,553952,1145859,2479152,11236,2009,315,91,13651
1615,2019-06-03,65.34,640918,130056,568521,1079383,2418878,10647,2325,293,114,13379
1616,2019-06-04,65.165,620741,157214,587981,1051508,2417444,9860,3053,304,104,13321
1617,2019-06-05,65.395,558668,176501,631246,1013413,2379828,9297,3684,286,120,13387
1618,2019-06-06,65.085,572697,225593,670422,1017526,2486238,9046,3938,280,127,13391
1619,2019-06-07,64.805,554525,238074,705950,1022401,2520950,8886,3872,273,133,13164
1620,2019-06-10,64.78,567628,223934,693044,1036738,2521344,9574,3749,273,142,13738
1621,2019-06-11,64.5575,576094,197003,657700,1036791,2467588,9855,3512,273,141,13781
1622,2019-06-13,64.58,583743,175747,657325,1065321,2482136,10174,3075,292,116,13657
1623,2019-06-14,64.38,581848,267013,676756,991591,2517208,9512,4075,280,136,14003
1624,2019-06-17,64.32,574732,232114,648845,991463,2447154,9435,4012,283,146,13876
1625,2019-06-18,64.02,578094,253556,693870,1018408,2543928,9376,3897,279,147,13699
1626,2019-06-19,63.785,537563,229510,669248,977301,2413622,9061,3981,291,117,13450
1627,2019-06-20,62.89,440598,190038,558291,808851,1997778,7325,3578,232,114,11249
1628,2019-06-21,63.025,465016,119344,580845,926517,2091722,8401,2974,274,80,11729
1629,2019-06-24,62.6,466874,165616,610572,911830,2154892,8364,3777,271,106,12518
1630,2019-06-25,62.835,507340,110870,624712,1021182,2264104,8922,3331,282,93,12628
1631,2019-06-26,63.0725,579249,88714,664793,1155328,2488084,9731,2685,290,93,12799
1632,2019-06-27,63.0725,533952,96069,681486,1119369,2430876,9854,2756,277,108,12995
1633,2019-06-28,63.24,502096,154439,700719,1048376,2405630,9328,3162,268,118,12876
1634,2019-07-01,62.96,514683,212556,856454,1158581,2742274,9014,3794,273,117,13198
1635,2019-07-02,63.32,591456,99313,831025,1323168,2844962,10180,2317,309,75,12881
1636,2019-07-03,63.32,600903,101027,827285,1327161,2856376,10630,2031,321,72,13054
1637,2019-07-04,63.48,553629,108122,852823,1298330,2812904,10418,2318,293,90,13119
1638,2019-07-05,63.8025,618843,112743,879477,1385577,2996640,10423,2031,320,71,12845
1639,2019-07-08,63.695,546622,147336,896046,1295332,2885336,10095,2438,290,105,12928
1640,2019-07-09,63.915,594902,93514,863843,1365231,2917490,10481,1803,318,80,12682
1641,2019-07-10,63.18,501312,271321,908618,1138609,2819860,8710,4193,279,133,13315
1642,2019-07-11,62.815,513380,233298,874745,1154827,2776250,9271,4102,285,130,13788
1643,2019-07-12,62.9775,570323,112794,833637,1291166,2807920,10091,3015,315,91,13512
1644,2019-07-15,62.67,517466,233523,853278,1137221,2741488,8904,4185,286,129,13504
1645,2019-07-16,63.045,540707,137781,837257,1240183,2755928,9632,3295,299,106,13332
1646,2019-07-17,62.935,522642,163216,863012,1222438,2771308,9525,3502,292,113,13432
1647,2019-07-18,62.8075,705123,75097,831661,1461687,3073568,11770,1507,328,76,13681
1648,2019-07-19,63.055,649240,77030,837450,1409660,2973380,11177,1728,314,73,13292
1649,2019-07-22,63.095,611666,85648,863983,1390001,2951298,11078,1773,316,79,13246
1650,2019-07-23,63.16,734114,72503,875522,1537133,3219272,11869,1491,332,75,13767
1651,2019-07-24,63.2975,650989,97841,901911,1455059,3105800,11465,1915,311,104,13795
1652,2019-07-25,63.2375,618968,161050,901029,1358947,3039994,10341,2964,293,121,13719
1653,2019-07-26,63.3675,724483,76325,883735,1531893,3216436,11573,1553,341,77,13544
1654,2019-07-29,63.4325,712587,81290,872691,1503988,3170556,11521,1674,332,74,13601
1655,2019-07-30,63.5075,666423,102550,849599,1413472,3032044,10651,2009,320,95,13075
1656,2019-07-31,63.625,650895,90947,847501,1407449,2996792,11028,1775,322,75,13200
1657,2019-08-01,64.355,667088,110242,816923,1373769,2968022,10633,1995,327,78,13033
1658,2019-08-02,65.2725,583117,141357,832522,1274282,2831278,9518,2792,322,82,12714
1659,2019-08-05,65.53,506520,143746,851577,1214351,2716194,9302,2713,296,103,12414
1660,2019-08-06,65.2725,481971,147262,856147,1190856,2676236,8704,2762,296,107,11869
1661,2019-08-07,65.3325,570413,129028,800533,1241918,2741892,9165,2564,316,88,12133
1662,2019-08-08,65.045,549886,124763,827280,1252403,2754332,8917,2764,298,101,12080
1663,2019-08-09,65.2825,537881,140102,869401,1267180,2814564,8969,2682,325,87,12063
1664,2019-08-12,65.405,563133,153499,895502,1305136,2917270,8963,3074,320,98,12455
1665,2019-08-13,64.93,465490,215732,934168,1183926,2799316,7570,4076,289,134,12069
1666,2019-08-14,66.015,522698,156421,850328,1216605,2746052,8388,3177,330,89,11984
1667,2019-08-15,66.0575,523131,127031,808067,1204167,2662396,8796,2970,328,93,12187
1668,2019-08-16,66.52,499198,147626,803512,1155084,2605420,8463,3230,316,93,12102
1669,2019-08-19,66.89,470281,204507,803302,1069076,2547166,8098,4076,307,104,12585
1670,2019-08-20,66.565,371829,233499,909609,1047939,2562876,7334,4450,264,137,12185
1671,2019-08-21,65.75,364231,257685,916994,1023540,2562450,6930,4940,256,148,12274
1672,2019-08-22,65.6,422494,196384,778487,1004597,2401962,7270,4656,276,125,12327
1673,2019-08-23,65.985,447683,131980,745370,1061073,2386106,7762,3356,305,94,11517
1674,2019-08-26,66.07,468770,132113,735909,1072566,2409358,8666,2818,310,96,11890
1675,2019-08-27,66.4425,535350,157164,768115,1146301,2606930,9029,3150,319,94,12592
1676,2019-08-28,66.8,485559,172193,734085,1047451,2439288,8313,3572,308,105,12298
1677,2019-08-29,66.59,425663,205994,792099,1011768,2435524,7762,4075,281,126,12244
1678,2019-08-30,66.79,364630,197652,895927,1062905,2521114,6388,4664,268,137,11457
1679,2019-09-02,66.79,428917,184310,827902,1072509,2513638,7287,3842,286,124,11539
1680,2019-09-03,66.7575,551866,191482,721332,1081716,2546396,8174,3718,318,100,12310
1681,2019-09-04,66.2225,426332,297374,840041,968999,2532746,6464,5033,258,157,11912
1682,2019-09-05,66.215,409964,273925,803429,939468,2426786,6682,4764,261,152,11859
1683,2019-09-06,65.73,435966,289926,766083,912123,2404098,6827,4926,254,153,12160
1684,2019-09-09,65.55,443111,259651,752811,936271,2391844,6922,4365,265,146,11698
1685,2019-09-10,65.42,454309,197644,743566,1000231,2395750,7242,4125,272,129,11768
1686,2019-09-11,65.5,453868,185221,748544,1017191,2404824,7421,3965,274,134,11794
1687,2019-09-12,64.7,524312,259864,802371,1066819,2653366,8205,4417,260,141,13023
1688,2019-09-13,64.3375,570563,230401,805432,1145594,2751990,8956,4218,283,148,13605
1689,2019-09-16,64.045,541388,180807,793284,1153865,2669344,8569,4354,274,130,13327
1690,2019-09-17,64.36,584879,129685,774213,1229407,2718184,9776,3173,302,106,13357
1691,2019-09-18,64.15,554519,163637,774683,1165565,2658404,9870,2992,278,119,13259
1692,2019-09-19,64.005,382619,240119,682769,825269,2130776,7245,3703,230,109,11287
1693,2019-09-20,64.01,408898,136925,696216,968189,2210228,8118,3674,246,102,12140
1694,2019-09-23,63.835,438118,136499,696112,997731,2268460,8619,3508,254,103,12484
1695,2019-09-24,63.985,502741,130767,722087,1094061,2449656,9652,3343,256,109,13360
1696,2019-09-25,64.145,635929,78875,695430,1252484,2662718,10734,2367,284,89,13474
1697,2019-09-26,64.21,556254,82202,676122,1150174,2464752,10640,2412,267,102,13421
1698,2019-09-27,64.6975,582125,78882,653177,1156420,2470604,10633,2093,282,86,13094
1699,2019-09-30,64.865,630764,72357,646691,1205098,2554910,11102,1991,296,81,13470
1700,2019-10-01,65.265,616827,103594,676426,1189659,2586506,10464,2376,309,77,13226
1701,2019-10-02,65.195,501606,98891,805657,1208372,2614526,9569,2569,278,99,12515
1702,2019-10-03,65.1275,493311,111710,821646,1203247,2629914,8816,3194,285,83,12378
1703,2019-10-04,64.615,453373,253798,918309,1117884,2743364,7837,4669,253,123,12882
1704,2019-10-07,64.975,426735,152957,881162,1154940,2615794,7893,4146,275,99,12413
1705,2019-10-08,65.2,560696,109854,813462,1264304,2748316,9616,2678,303,83,12680
1706,2019-10-09,64.8875,434568,185429,901101,1150240,2671338,8048,4270,255,118,12691
1707,2019-10-10,64.4575,496038,223964,916670,1188744,2825416,8303,4554,256,127,13240
1708,2019-10-11,64.205,548862,227266,890043,1211639,2877810,8930,4341,251,124,13646
1709,2019-10-14,64.295,537801,124084,806081,1219798,2687764,9438,3560,264,104,13366
1710,2019-10-15,64.275,548166,120917,786406,1213655,2669144,9348,3511,274,97,13230
1711,2019-10-16,64.075,535433,287710,924937,1172660,2920740,8962,4552,271,113,13898
1712,2019-10-17,64.115,574407,288497,900799,1186709,2950412,9493,4475,275,113,14356
1713,2019-10-18,63.76,567219,171772,788925,1184372,2712288,9778,3645,288,92,13803
1714,2019-10-21,63.73,611122,253201,817170,1175091,2856584,10155,4309,289,110,14863
1715,2019-10-22,63.735,650617,221254,795580,1224943,2892394,10539,3766,302,98,14705
1716,2019-10-23,63.95,787607,105056,751283,1433834,3077780,12359,2405,313,86,15163
1717,2019-10-24,64.07,805649,74558,778673,1509764,3168644,13227,1720,323,80,15350
1718,2019-10-25,63.8525,746467,245512,845883,1346838,3184700,11856,3869,285,122,16132
1719,2019-10-28,63.75,773375,206764,806279,1372890,3159308,12330,3932,288,120,16670
1720,2019-10-29,63.95,843392,92201,785726,1536917,3258236,13494,2332,304,94,16224
1721,2019-10-30,63.835,866575,65107,784660,1586128,3302470,14213,1721,316,89,16339
1722,2019-10-31,64.13,833723,61186,828587,1601124,3324620,13718,1743,310,82,15853
1723,2019-11-01,63.54,813115,223030,861241,1451326,3348712,12537,3798,268,125,16728
1724,2019-11-05,63.4925,762554,155997,823783,1430340,3172674,12394,3353,278,110,16135
1725,2019-11-06,63.8725,832720,123800,794464,1503384,3254368,13344,2354,290,102,16090
1726,2019-11-07,63.52,783076,126601,818575,1475050,3203302,13004,2835,264,121,16224
1727,2019-11-08,63.8,808576,96886,804793,1516483,3226738,13698,1787,308,85,15878
1728,2019-11-11,63.89,790594,88961,815340,1516973,3211868,13838,1991,309,92,16230
1729,2019-11-12,64.23,898740,86192,795432,1607980,3388344,14103,1740,315,88,16246
1730,2019-11-13,64.35,849872,80031,822663,1592504,3345070,13675,1845,319,90,15929
1731,2019-11-14,63.98,715035,154641,816967,1377361,3064004,13254,2303,288,117,15962
1732,2019-11-15,63.7675,741692,223458,905619,1423853,3294622,12197,4030,278,141,16646
1733,2019-11-18,63.8225,742957,140820,845574,1447711,3177062,12833,3409,296,113,16651
1734,2019-11-19,63.82,732665,137685,870338,1465318,3206006,12441,3659,275,138,16513
1735,2019-11-20,63.89,809320,91247,804482,1522555,3227604,14161,1565,315,92,16133
1736,2019-11-21,63.72,778136,226387,905480,1457229,3367232,13211,3395,290,125,17021
1737,2019-11-22,63.87,758409,190301,874361,1442469,3265540,12706,3782,287,122,16897
1738,2019-11-25,63.94,944636,103280,803372,1644728,3496016,14383,1873,315,86,16657
1739,2019-11-26,63.95,879965,98310,788143,1569798,3336216,14148,1830,313,87,16378
1740,2019-11-27,63.96,824172,98326,781237,1507083,3210818,14048,1968,304,93,16413
1741,2019-11-28,64.07,966713,82157,780894,1665450,3495214,14323,1894,308,87,16612
1742,2019-11-29,64.3175,1008856,82262,764152,1690746,3546016,14200,1824,318,83,16425
1743,2019-12-02,64.175,889305,79904,786596,1595997,3351802,13990,1976,319,80,16365
1744,2019-12-03,64.145,880538,131818,823273,1571993,3407622,13782,2578,305,96,16761
1745,2019-12-04,63.95,825530,285662,905368,1445236,3461796,12729,3985,275,126,17115
1746,2019-12-05,63.7225,843168,245875,874403,1471696,3435142,12862,3820,287,109,17078
1747,2019-12-06,63.755,878338,265688,882439,1495089,3521554,12914,3715,291,107,17027
1748,2019-12-09,63.59,879046,210001,845550,1514595,3449192,13194,3753,302,105,17354
1749,2019-12-10,63.4925,923439,245950,862763,1540252,3572404,13161,3934,289,112,17496
1750,2019-12-11,63.27,929363,179760,868097,1617700,3594920,13515,3666,292,112,17585
1751,2019-12-12,62.8425,900105,286505,906790,1520390,3613790,13088,3888,281,124,17381
1752,2019-12-13,62.8975,884712,129604,778605,1533713,3326634,12894,2481,289,108,15772
1753,2019-12-16,62.445,888141,174200,877932,1591873,3532146,12817,2951,278,126,16172
1754,2019-12-17,62.415,888659,144210,848446,1592895,3474210,13156,2786,304,98,16344
1755,2019-12-18,62.665,846824,181673,878605,1543756,3450858,12545,2888,273,113,15819
1756,2019-12-19,62.405,637650,248588,457964,847026,2191228,9518,3575,235,103,13431
1757,2019-12-20,62.2525,654740,244600,461969,872109,2233418,9982,3648,239,109,13978
1758,2019-12-23,62.265,720599,117051,445636,1049184,2332470,10909,3067,258,90,14324
1759,2019-12-24,61.9675,695003,316407,445972,824568,2281950,10542,3982,236,112,14872
1760,2019-12-25,61.85,721137,212405,417405,926137,2277084,11158,3541,239,114,15052
1761,2019-12-26,62.215,811433,126991,413449,1097891,2449764,12298,2266,274,88,14926
1762,2019-12-27,62.0325,755446,119423,408414,1044437,2327720,12320,2131,250,99,14800
1763,2019-12-30,61.985,741614,139645,423815,1025784,2330858,11464,2992,245,97,14798
1764,2020-01-03,62.1,742345,124217,410817,1028945,2306324,12025,2363,257,80,14725
1765,2020-01-06,61.82,737782,150757,409738,996763,2295040,11697,3078,253,95,15123
1766,2020-01-08,61.2475,732611,172827,416620,976404,2298462,11422,3621,250,103,15396
1767,2020-01-09,61.2925,737703,166433,447411,1018681,2370228,11694,3566,257,104,15621
1768,2020-01-10,61.06,769457,204852,455438,1020043,2449790,11853,3500,258,107,15718
1769,2020-01-13,61.2725,786205,141351,489722,1134576,2551854,12002,3209,268,96,15575
1770,2020-01-14,61.445,834846,92198,488470,1231118,2646632,13363,2136,284,85,15868
1771,2020-01-15,61.4175,815558,104574,490145,1201129,2611406,13634,1914,284,89,15921
1772,2020-01-16,61.6625,773864,108530,554568,1219902,2656864,13590,2127,286,89,16092
1773,2020-01-17,61.555,696512,270626,613112,1038998,2619248,11925,3956,249,125,16255
1774,2020-01-20,61.5475,778845,157219,541413,1163039,2640516,12995,2796,278,92,16161
1775,2020-01-21,61.8825,799550,130685,558590,1227455,2716280,13393,2276,286,84,16039
1776,2020-01-22,61.8425,817037,128357,541726,1230406,2717526,13713,2169,285,87,16254
1777,2020-01-23,61.905,742682,132141,596284,1206825,2677932,13223,2328,267,97,15915
1778,2020-01-24,62.07,680328,185881,615266,1109713,2591188,12086,3366,264,106,15822
1779,2020-01-27,62.97,775121,123320,598891,1250692,2748024,12386,2257,295,79,15017
1780,2020-01-28,62.2925,653574,142960,641744,1152358,2590636,11791,2242,263,102,14398
1781,2020-01-29,62.54,700630,122451,650932,1229111,2703124,11941,2045,279,81,14346
1782,2020-01-30,63.26,674537,138098,693190,1229629,2735454,11721,2493,294,86,14594
1783,2020-01-31,63.915,642626,137209,757145,1262562,2799542,11176,2771,295,84,14326
1784,2020-02-03,63.725,583196,152202,850301,1281295,2866994,10336,2956,260,113,13665
1785,2020-02-04,63.105,527135,232993,951554,1245696,2957378,9111,4481,255,128,13975
1786,2020-02-05,62.87,548678,205048,908827,1252457,2915010,9329,4294,240,133,13996
1787,2020-02-06,63.355,604888,142342,808290,1270836,2826356,9750,3429,279,96,13554
1788,2020-02-07,64.125,611372,169068,929052,1371356,3080848,9770,3162,290,96,13318
1789,2020-02-10,64.13,591371,153502,943004,1380873,3068750,10317,2915,292,97,13621
1790,2020-02-11,63.3725,512985,273727,1136810,1376068,3299590,8589,4936,244,145,13914
1791,2020-02-12,63.2125,532252,259841,1056102,1328513,3176708,9203,4697,246,131,14277
1792,2020-02-13,63.6325,570006,158931,930083,1341158,3000178,9818,3432,265,119,13634
1793,2020-02-14,63.5625,518348,181921,985174,1321601,3007044,8732,4214,243,128,13317
1794,2020-02-17,63.4675,497745,195791,1038378,1340332,3072246,8915,4337,247,128,13627
1795,2020-02-18,63.81,588489,195897,982204,1374796,3141386,10290,2796,272,99,13457
1796,2020-02-19,63.575,493426,278224,1073576,1288778,3134004,9192,4091,239,136,13658
1797,2020-02-20,64.2,637325,200757,950749,1387317,3176148,10136,3079,260,112,13587
1798,2020-02-21,64.0725,616072,192711,942189,1365550,3116522,9788,3263,272,99,13422
1799,2020-02-25,65.385,535008,255049,1168647,1448606,3407310,8846,3847,269,102,13064
1800,2020-02-26,65.47,450556,276501,1204006,1378061,3309124,8224,4017,248,125,12614
1801,2020-02-27,66.015,533758,240944,1099594,1392408,3266704,8117,4168,279,111,12675
1802,2020-02-28,66.8775,461944,262597,1071099,1270446,3066086,7525,3825,260,120,11730
1803,2020-03-02,66.4425,461137,280984,1045301,1225454,3012876,7394,4432,252,121,12199
1804,2020-03-03,66.04,419352,344704,1034063,1108711,2906830,6172,5048,234,140,11594
1805,2020-03-04,66.26,413949,300246,1080473,1194176,2988844,5950,5129,241,127,11447
1806,2020-03-05,67.62,479671,354647,1057720,1182744,3074782,7248,4720,272,109,12349
1807,2020-03-06,68.5725,446240,310671,1137742,1273311,3167964,7147,4701,258,123,12229
1808,2020-03-10,71.4,432762,215816,1021500,1238446,2908524,7695,2887,257,114,10953
1809,2020-03-11,72.95,461754,212806,965081,1214029,2853670,7606,2996,263,107,10972
1810,2020-03-12,74.85,492237,200330,954894,1246801,2894262,7554,3058,248,116,10976
1811,2020-03-13,72.5975,411687,215739,866628,1062576,2556630,6327,3573,228,120,10248
1812,2020-03-16,74.6525,434057,169450,838902,1103509,2545918,7690,2683,233,114,10720
1813,2020-03-17,75.4425,439161,186067,818623,1071717,2515568,7599,3181,242,100,11122
1814,2020-03-18,80.87,401077,229920,753558,924715,2309270,7364,3678,244,114,11400
1815,2020-03-19,79.125,273812,98543,472754,648023,1493132,6110,2805,208,96,9219
1816,2020-03-20,79.9325,300292,89514,514972,725750,1630528,6153,3197,209,92,9651
1817,2020-03-23,79.6,299572,95909,492931,696594,1585006,7522,2843,218,90,10673
1818,2020-03-24,78.28,271150,135738,460073,595485,1462446,6223,3986,201,116,10526
1819,2020-03-25,78.25,319370,82942,382808,619236,1404356,6883,3256,222,105,10466
1820,2020-03-26,77.4675,341359,146807,397197,591749,1477112,6619,4173,202,124,11118
1821,2020-03-27,78.82,423257,79340,356903,700820,1560320,7742,3140,246,85,11213
1822,2020-03-30,79.32,424902,87023,354829,692708,1559462,9148,2411,248,87,11894
1823,2020-03-31,78.3725,369018,141056,430540,658502,1599116,7513,4077,226,109,11925
1824,2020-04-01,78.79,368670,105007,406469,670132,1550278,8231,3126,240,99,11696
1825,2020-04-02,77.25,336021,101649,425948,660320,1523938,7038,3315,226,112,10691
1826,2020-04-03,76.4925,297973,137648,468839,629164,1533624,6501,4127,220,126,10974
1827,2020-04-06,76.02,316033,144595,510500,681938,1653066,6678,4286,213,124,11301
1828,2020-04-07,75.54,358962,121332,469489,707119,1656902,7414,3938,224,125,11701
1829,2020-04-08,74.9725,351597,126553,492162,717206,1687518,7382,3826,237,123,11568
1830,2020-04-09,74.3,367286,148431,503645,722500,1741862,7533,3845,220,129,11727
1831,2020-04-10,73.75,372600,102948,483565,753217,1712330,7829,3416,220,124,11589
1832,2020-04-13,73.61,381111,92036,489771,778846,1741764,8368,3322,243,113,12046
1833,2020-04-14,73.0025,402870,139634,490835,754071,1787410,8771,3760,245,126,12902
1834,2020-04-15,74.8125,491805,81515,475394,885684,1934398,10623,2518,278,97,13516
1835,2020-04-16,74.15,454257,109688,480703,825272,1869920,10229,3135,263,118,13745
1836,2020-04-17,73.99,426246,84401,483476,825321,1819444,9501,2885,257,115,12758
1837,2020-04-20,75.55,477543,82999,450353,844897,1855792,10516,2485,271,96,13368
1838,2020-04-21,77.08,513633,96751,420138,837020,1867542,10536,2288,277,85,13186
1839,2020-04-22,75.9025,470191,111875,507145,865461,1954672,9135,2936,250,112,12433
1840,2020-04-23,74.77,427586,145884,539427,821129,1934026,8044,4348,234,119,12745
1841,2020-04-24,74.545,436899,115225,510459,832133,1894716,8059,3884,247,109,12299
1842,2020-04-27,74.495,458597,94923,474889,838563,1866972,8511,3693,244,115,12563
1843,2020-04-28,74.1425,409526,152672,457114,713968,1733280,7968,4259,235,118,12580
1844,2020-04-29,73.01,429615,181351,447723,695987,1754676,8029,4608,229,124,12990
1845,2020-04-30,74.395,446225,121129,439279,764375,1771008,8602,3576,215,95,12488
1846,2020-05-04,74.845,430707,123607,426812,733912,1715038,8257,2605,205,89,11156
1847,2020-05-05,73.75,373262,202062,516405,687605,1779334,7533,4251,191,105,12080
1848,2020-05-06,74.58,453158,133415,428322,748065,1762960,9285,2514,215,83,12097
1849,2020-05-07,74.1,407128,184253,430076,652951,1674408,8090,4441,187,121,12839
1850,2020-05-08,73.4,430273,225255,459971,664989,1780488,8573,4976,199,125,13873
1851,2020-05-12,73.71,424145,221531,440541,643155,1729372,8784,5143,197,120,14244
1852,2020-05-13,73.94,506422,147333,430136,789225,1873116,10280,3243,236,90,13849
1853,2020-05-14,73.48,514122,145239,490301,859184,2008846,11052,2367,250,81,13750
1854,2020-05-15,73.58,454933,171371,478853,762415,1867572,9324,3710,227,84,13345
1855,2020-05-18,72.6775,458660,252156,509210,715714,1935740,9075,5386,203,127,14791
1856,2020-05-19,72.465,487486,197896,455786,745376,1886544,9396,4983,213,121,14713
1857,2020-05-20,71.09,499429,273964,545652,771117,2090162,9933,5480,208,132,15753
1858,2020-05-21,70.9675,509389,197273,442366,754482,1903510,10768,4765,222,115,15870
1859,2020-05-22,71.64,571321,107684,454495,918132,2051632,11344,3549,222,100,15215
1860,2020-05-25,71.65,545533,135993,440419,849959,1971904,11337,3959,213,108,15617
1861,2020-05-26,70.78,572306,220449,479975,831832,2104562,10881,5704,216,135,16936
1862,2020-05-27,71.01,588641,125254,522144,985531,2221570,11388,4758,242,103,16491
1863,2020-05-28,70.485,555258,243882,719062,1030438,2548640,11015,5869,219,131,17234
1864,2020-05-29,70.1425,572173,155409,721199,1137963,2586744,10942,5248,230,112,16532
1865,2020-06-01,69.12,549119,225124,819400,1143395,2737038,11245,5626,222,129,17222
1866,2020-06-02,68.73,550454,229698,845947,1166703,2792802,11736,5486,227,130,17579
1867,2020-06-03,68.665,572651,167353,812260,1217558,2769822,12449,4703,243,108,17503
1868,2020-06-04,69.1525,677315,142229,713394,1248480,2781418,14872,2977,263,87,18199
1869,2020-06-05,68.7,557158,246901,895378,1205635,2905072,12690,5081,227,127,18125
1870,2020-06-08,68.2,620707,153657,772757,1239807,2786928,12926,4977,246,109,18258
1871,2020-06-09,68.585,644611,116757,753574,1281428,2796370,13307,3366,253,104,17030
1872,2020-06-10,68.5,674536,128475,691105,1237166,2731282,13586,3760,266,92,17704
1873,2020-06-11,70.2,722246,111982,652226,1262490,2748944,14082,3107,266,93,17548
1874,2020-06-15,69.5775,663043,138213,606296,1131126,2538678,13183,3588,242,110,17123
1875,2020-06-16,69.6175,565413,184418,631896,1012891,2394618,12118,4559,233,120,17030
1876,2020-06-17,69.74,613569,124016,589451,1079004,2406040,12873,3792,248,101,17014
1877,2020-06-18,69.8625,474372,120901,429574,783045,1807892,9815,4379,204,92,14490
1878,2020-06-19,69.4375,519432,163235,447743,803940,1934350,10436,4659,201,108,15404
1879,2020-06-22,69.02,535376,204483,447378,778271,1965508,10860,4887,203,111,16061
1880,2020-06-23,68.8625,519840,244536,454400,729704,1948480,11005,5307,197,124,16633
1881,2020-06-25,69.02,605340,105730,462406,962016,2135492,11957,3604,223,100,15884
1882,2020-06-26,69.8,659640,89612,523081,1093109,2365442,12556,3259,251,80,16146
1883,2020-06-29,69.99,669679,106933,527986,1090732,2395330,13137,3326,250,81,16794
1884,2020-06-30,71.2775,687427,154468,567391,1100350,2509636,12833,3823,259,74,16989
1885,2020-07-02,70.5525,660001,127946,558710,1090765,2437422,12915,4072,224,101,17312
1886,2020-07-03,71.37,726826,139204,571437,1159059,2596526,14044,3550,264,71,17929
1887,2020-07-06,71.8275,675461,129725,585445,1131181,2521812,13610,3514,242,90,17456
1888,2020-07-07,71.4725,674234,139956,607539,1141817,2563546,14129,3870,227,104,18330
1889,2020-07-08,71.11,693970,143501,594209,1144678,2576358,13979,4385,249,86,18699
1890,2020-07-09,70.915,707111,167823,572919,1112207,2560060,13302,5316,228,98,18944
1891,2020-07-10,70.7275,692045,159616,595019,1127448,2574128,13186,5759,215,114,19274
1892,2020-07-13,70.97,723426,186686,572381,1109121,2591614,13337,5670,238,108,19353
1893,2020-07-14,70.865,774683,103468,592945,1264160,2735256,14916,3523,257,82,18778
1894,2020-07-15,70.99,716287,131864,651523,1235946,2735620,13867,4255,243,98,18463
1895,2020-07-16,71.53,742070,142036,637004,1237038,2758148,15083,3422,252,99,18856
1896,2020-07-17,71.8725,803691,136158,598116,1265649,2803614,15221,3413,270,88,18992
1897,2020-07-20,71.3325,720850,190586,665408,1195672,2772516,13865,3963,243,110,18181
1898,2020-07-21,70.705,678057,241774,742582,1178865,2841278,12638,5722,221,127,18708
1899,2020-07-22,71.0575,729059,136998,603022,1195083,2664162,13166,4808,259,98,18331
1900,2020-07-23,71.47,822865,130479,612379,1304765,2870488,14436,3373,276,79,18164
1901,2020-07-24,71.735,787292,126234,568274,1229332,2711132,13924,3436,262,85,17707
1902,2020-07-27,71.5725,709324,132901,567178,1143601,2553004,13940,3378,256,99,17673
1903,2020-07-28,72.59,774400,179441,619514,1214473,2787828,13703,4276,269,89,18337
1904,2020-07-29,72.57,742201,135361,598517,1205357,2681436,13966,3698,258,90,18012
1905,2020-07-30,73.17,748994,158968,670962,1260988,2839912,13734,4445,273,94,18546
1906,2020-07-31,74.42,745172,196022,662488,1211638,2815320,13043,4869,273,93,18278
1907,2020-08-03,73.1125,607404,207681,724590,1124313,2663988,10829,5884,230,119,17062
1908,2020-08-04,73.56,618142,181816,671116,1107442,2578516,10898,5241,254,97,16490
1909,2020-08-05,72.88,631694,268475,712436,1075655,2688260,10970,6234,223,136,17563
1910,2020-08-06,73.2825,712730,170237,552048,1094541,2529556,11987,4773,245,101,17106
1911,2020-08-07,73.7275,755406,149557,554639,1160488,2620090,12995,3784,274,85,17138
1912,2020-08-10,73.4725,684935,203573,593838,1075200,2557546,12169,4640,241,113,17163
1913,2020-08-11,73.11,710084,259181,638901,1089804,2697970,12192,5497,234,126,18049
1914,2020-08-12,73.7125,765877,192136,557414,1131155,2646582,12490,4442,254,103,17289
1915,2020-08-13,72.9425,734493,197294,609349,1146548,2687684,12380,4967,229,134,17710
1916,2020-08-14,72.875,774852,212150,609612,1172314,2768928,12464,5499,234,131,18328
1917,2020-08-17,73.735,824241,171228,620937,1273950,2890356,13443,4474,262,106,18285
1918,2020-08-18,73.16,758303,210193,594516,1142626,2705638,12845,5248,235,134,18462
1919,2020-08-19,73.3025,759959,196478,680833,1244314,2881584,13330,4805,260,110,18505
1920,2020-08-20,73.79,850375,224365,619588,1245598,2939926,14418,4824,315,100,19657
1921,2020-08-21,74.8,788401,278062,704505,1214844,2985812,12761,5659,311,100,18831
1922,2020-08-24,74.6675,735563,218493,657262,1174332,2785650,13094,5295,269,138,18796
1923,2020-08-25,75.3275,827699,227195,692462,1292966,3040322,13468,5548,295,111,19422
1924,2020-08-26,75.3775,759092,244164,808914,1323842,3136012,12761,6080,286,121,19248
1925,2020-08-27,74.965,727121,224140,767941,1270922,2990124,11993,6212,261,140,18606
1926,2020-08-28,74.0125,795608,240598,717370,1272380,3025956,12893,6508,272,140,19813
1927,2020-08-31,74.075,857980,186301,672935,1344614,3061830,13934,5437,292,119,19782
1928,2020-09-01,73.5775,824363,236828,714636,1302171,3077998,13730,6325,278,146,20479
1929,2020-09-02,75.41,809078,278175,705600,1236503,3029356,13361,5733,312,106,19512
1930,2020-09-03,75.28,733266,244156,705589,1194699,2877710,13190,5851,278,128,19447
1931,2020-09-04,75.4325,761071,225998,669298,1204371,2860738,14091,5385,302,116,19894
1932,2020-09-07,75.77,805754,236406,687317,1256665,2986142,14364,5547,297,116,20324
1933,2020-09-08,76.28,800265,287537,750827,1263555,3102184,13394,6131,292,128,19945
1934,2020-09-09,75.325,744333,312968,831802,1263167,3152270,12153,7703,261,159,20276
1935,2020-09-10,75.2525,781497,288774,859609,1352332,3282212,12155,6761,258,151,19325
1936,2020-09-11,75.05,792164,212474,815009,1394699,3214346,12415,6153,277,124,18969
1937,2020-09-14,75.2725,853088,166736,773875,1460227,3253926,13477,4748,293,111,18629
1938,2020-09-15,74.99,736838,232840,870078,1374076,3213832,12045,5603,258,138,18044
1939,2020-09-16,74.97,724966,243883,846707,1327790,3143346,11700,5800,264,136,17900
1940,2020-09-17,75.17,677800,167149,559569,1070220,2474738,10636,3676,244,96,14652
1941,2020-09-18,75.745,734720,194305,587751,1128166,2644942,12289,4223,263,97,16872
1942,2020-09-21,76.13,764008,248272,631056,1146792,2790128,12274,5131,278,96,17779
1943,2020-09-22,76.1075,618722,264154,661400,1015968,2560244,11558,5420,263,115,17356
1944,2020-09-23,77.0825,708066,306835,683283,1084514,2782698,11631,6169,263,110,18173
1945,2020-09-24,77.14,548969,348904,786271,986336,2670480,10451,7162,266,119,17998
1946,2020-09-25,78.2075,580542,475235,899805,1005112,2960694,9854,8758,266,127,19005
1947,2020-09-28,79.08,619340,479220,904034,1044154,3046748,10573,8845,264,143,19825
1948,2020-09-29,79.0775,532032,461617,873169,943584,2810402,9081,9184,229,157,18651
1949,2020-09-30,77.63,555214,489977,901055,966292,2912538,8347,11057,223,162,19789
1950,2020-10-01,77.365,619226,386116,756127,989237,2750706,9749,9532,241,147,19669
1951,2020-10-02,78.2025,636838,386977,834263,1084124,2942202,10546,8196,259,133,19134
1952,2020-10-05,78.105,617641,401603,766271,982309,2767824,10790,7999,247,140,19176
1953,2020-10-06,78.465,546488,483000,808425,871913,2709826,8583,10387,216,167,19353
1954,2020-10-07,78.0225,598911,368352,703946,934505,2605714,9486,9093,240,142,18961
1955,2020-10-08,77.3575,629452,506008,755537,878981,2769978,9909,9861,227,157,20154
1956,2020-10-09,76.7675,654852,447122,784785,992515,2879274,9489,9788,212,171,19660
1957,2020-10-12,77.105,627075,375220,773705,1025560,2801560,10214,8386,234,148,18982
1958,2020-10-13,77.05,652900,343720,742962,1052142,2791724,10750,7802,239,143,18934
1959,2020-10-14,77.64,810989,343246,689669,1157412,3001316,13631,6374,263,125,20393
1960,2020-10-15,78.075,849991,360795,664748,1153944,3029478,12814,7236,260,129,20439
1961,2020-10-16,77.9375,645528,376415,775186,1044299,2841428,10523,7940,230,156,18849
1962,2020-10-19,77.665,658141,478642,831511,1011010,2979304,9704,10374,224,181,20483
1963,2020-10-20,77.34,713116,385331,714886,1042671,2856004,10584,8909,235,167,19895
1964,2020-10-21,76.725,752018,442293,781535,1091260,3067106,11015,9548,225,185,20973
1965,2020-10-22,76.5825,776881,440172,800016,1136725,3153794,11288,10385,228,186,22087
1966,2020-10-23,76.125,740091,446853,794061,1087299,3068304,11724,9911,231,183,22049
1967,2020-10-26,76.38,790948,417353,769912,1143507,3121720,12199,9545,240,176,22160
1968,2020-10-27,77.31,945333,262355,693606,1376584,3277878,14365,6354,285,135,21139
1969,2020-10-28,79.23,821607,343034,793453,1272026,3230120,12904,7591,257,131,20883
1970,2020-10-29,78.875,639533,377530,810837,1072840,2900740,10931,7722,240,141,19034
1971,2020-10-30,79.53,613775,386142,736148,963781,2699846,10742,8289,238,141,19410
1972,2020-11-02,80.55,611992,394487,724710,942215,2673404,11744,8210,244,141,20339
1973,2020-11-03,79.345,542435,390146,729707,881996,2544284,9248,7990,194,153,17585
1974,2020-11-05,77.0,619158,320553,706709,1005314,2651734,10785,8284,202,168,19439
1975,2020-11-06,77.41,705142,210901,640726,1134967,2691736,12692,5438,222,147,18499
1976,2020-11-09,76.28,759683,333225,809950,1236408,3139266,12262,8616,200,172,21250
1977,2020-11-10,76.55,775670,250985,755553,1280238,3062446,13917,7825,226,153,22121
1978,2020-11-11,77.1325,878700,217282,682950,1344368,3123300,17199,4759,239,142,22339
1979,2020-11-12,77.37,908465,207526,691370,1392309,3199670,17630,4635,251,141,22657
1980,2020-11-13,77.3875,918645,245791,678910,1351764,3195110,17894,4769,270,124,23057
1981,2020-11-16,76.16,831225,438989,799772,1192008,3261994,14265,9766,215,175,24421
1982,2020-11-17,76.22,852641,320561,731661,1263741,3168604,15686,8249,224,161,24320
1983,2020-11-18,76.06,809441,399977,782682,1192146,3184246,14644,9165,211,173,24193
1984,2020-11-19,76.05,944123,213299,734131,1464955,3356508,17634,4628,253,122,22637
1985,2020-11-20,76.2,866373,261010,731847,1337210,3196440,16134,6206,232,134,22706
1986,2020-11-23,76.175,865823,289682,728081,1304222,3187808,15095,7382,235,156,22868
1987,2020-11-24,75.48,814546,296336,708979,1227189,3047050,14816,7856,234,154,23060
1988,2020-11-25,75.5625,808405,278874,708958,1238489,3034726,14757,8166,240,154,23317
1989,2020-11-26,75.715,818654,273833,687567,1232388,3012442,14741,8281,238,156,23416
1990,2020-11-27,75.8525,1034516,210533,653028,1477011,3375088,19138,4318,268,132,23856
1991,2020-11-30,76.39,934816,243845,688681,1379652,3246994,18926,4756,253,139,24074
1992,2020-12-01,75.8475,849940,463065,853052,1239927,3405984,15174,9254,230,173,24831
1993,2020-12-02,75.07,882287,445941,823295,1259641,3411164,14947,10113,226,184,25470
1994,2020-12-03,74.45,877050,482319,902892,1297623,3559884,15083,10306,242,178,25809
1995,2020-12-04,74.05,834722,442531,886661,1278852,3442766,14393,10028,233,181,24835
1996,2020-12-07,73.64,854130,413510,840459,1281079,3389178,15287,9665,240,176,25368
1997,2020-12-08,73.505,803582,410541,797135,1190176,3201434,15199,9760,241,170,25370
1998,2020-12-09,73.86,874365,219555,730599,1385409,3209928,16502,6763,262,142,23669
1999,2020-12-10,73.0475,828456,408118,886329,1306667,3429570,15079,9956,231,170,25436
2000,2020-12-10,73.0475,828456,408118,886329,1306667,3429570,15079,9956,231,170,25436
2001,2020-12-11,72.945,833147,279777,774977,1328347,3216248,15843,8066,230,163,24302
2002,2020-12-14,73.87,854382,261770,703252,1295864,3115268,16423,7322,251,149,24145
2003,2020-12-15,73.3925,883507,205461,716773,1394819,3200560,17718,5620,269,125,23732
2004,2020-12-16,73.3475,859199,217390,731387,1373196,3181172,16877,5691,259,142,22969
2005,2020-12-17,72.8325,578541,349735,566608,795414,2290298,12209,8597,194,139,21139
2006,2020-12-18,73.3475,747470,185090,598837,1161217,2692614,15300,5327,239,110,20976
2007,2020-12-21,74.8,718874,192640,582881,1109115,2603510,16054,4314,241,105,20714
2008,2020-12-22,75.91,612548,259119,491625,845054,2208346,16243,4854,244,111,21452
2009,2020-12-23,75.08,569531,294746,528468,803253,2195998,14312,5443,212,135,20102
2010,2020-12-24,73.895,686959,405950,529056,810065,2432030,12594,9882,192,168,22836
2011,2020-12-25,74.17,725144,266585,526054,984613,2502396,13974,7039,226,128,21367
2012,2020-12-28,73.77,695415,362890,506666,839191,2404162,13423,9138,225,142,22928
2013,2020-12-29,74.0375,678545,248142,493050,923453,2343190,13438,7424,213,145,21220
2014,2020-12-30,74.415,786597,184965,526376,1128008,2625946,16036,3708,260,97,20101
2015,2021-01-04,74.33,640804,257022,701751,1085533,2685110,12728,7820,217,147,20912
2016,2021-01-05,74.04,655856,209466,597422,1043812,2506556,14709,4093,250,109,19161
2017,2021-01-06,73.9225,669902,183475,596767,1083194,2533338,14859,4810,239,124,20032
2018,2021-01-08,74.155,671490,209873,598271,1059888,2539522,14470,3995,245,114,18824
2019,2021-01-11,74.66,774205,228205,637334,1183334,2823078,17470,4840,264,117,22691
2020,2021-01-12,73.54,774159,337662,704236,1140733,2956790,14388,8930,221,165,23704
2021,2021-01-13,73.7475,797696,296500,647816,1149012,2891024,15730,8671,231,148,24780
2022,2021-01-14,73.21,806431,433594,719442,1092279,3051746,15986,9525,222,167,25900
2023,2021-01-15,73.645,855286,224245,671780,1302821,3054132,17035,6732,249,135,24151
2024,2021-01-18,73.995,966815,208552,661749,1420012,3257128,20232,4211,273,123,24839
2025,2021-01-19,73.68,865007,227177,699817,1337647,3129648,19196,4904,263,124,24487
2026,2021-01-20,73.52,806565,312509,760636,1254692,3134402,16098,9367,234,156,25855
2027,2021-01-21,73.845,931825,194848,783558,1520535,3430766,21223,3943,279,111,25556
2028,2021-01-22,75.3,838724,310584,902156,1430296,3481760,18050,5686,270,120,24126
2029,2021-01-25,75.3675,836169,329822,921114,1427461,3514566,18547,5973,270,121,24911
2030,2021-01-26,75.085,660452,367110,947905,1241247,3216714,15893,6331,232,151,22607
2031,2021-01-27,75.85,831752,395536,998054,1434270,3659612,17317,6908,265,128,24618
2032,2021-01-28,75.9575,749022,423958,952194,1277258,3402432,17886,6939,255,138,25218
2033,2021-01-29,75.755,704562,445915,904329,1162976,3217782,16104,8706,247,148,25205
2034,2021-02-01,76.1475,709516,358908,760829,1111437,2940690,16327,6135,271,126,22859
2035,2021-02-02,76.225,642899,416451,836509,1062957,2958816,14144,7185,226,167,21722
2036,2021-02-03,75.9275,700082,348238,707526,1059370,2815216,16614,6173,253,145,23185
2037,2021-02-04,75.505,672809,452893,797175,1017091,2939968,14807,9223,220,172,24422
2038,2021-02-05,74.645,781187,481284,743461,1043364,3049296,15507,10237,226,175,26145
2039,2021-02-08,74.3,734032,451760,684348,966620,2836760,15095,10512,218,170,25995
2040,2021-02-09,73.8875,808615,404754,670110,1073971,2957450,16179,9996,225,176,26576
2041,2021-02-10,73.945,832741,352714,680267,1160294,3026016,16744,8390,240,171,25545
2042,2021-02-11,73.605,902753,480751,688612,1110614,3182730,18347,10104,241,175,28867
2043,2021-02-12,73.7175,1022678,269390,628773,1382061,3302902,22144,4410,294,127,26975
2044,2021-02-15,73.325,866332,356347,764828,1274813,3262320,17328,8514,227,187,26256
2045,2021-02-16,73.64,936878,265933,638344,1309289,3150444,18109,6984,265,137,25495
2046,2021-02-17,73.71,998895,312193,683797,1370499,3365384,21104,5032,296,122,26554
2047,2021-02-18,73.91,915608,314550,670127,1271185,3171470,18580,4757,280,124,23741
2048,2021-02-19,74.125,859610,296129,737131,1300612,3193482,18961,4460,271,144,23836
2049,2021-02-20,74.08,876275,281374,729829,1324730,3212208,19931,4107,282,121,24441
2050,2021-02-22,74.3,916575,293268,749447,1372754,3332044,20792,4416,288,123,25619
2051,2021-02-24,73.54,850671,369468,933577,1414780,3568496,17741,8950,250,170,27111
2052,2021-02-25,74.75,845106,306366,897931,1436671,3486074,17560,6291,265,147,24263
2053,2021-02-26,74.63,852783,320906,943288,1475165,3592142,19925,5050,268,127,25370
2054,2021-03-01,74.165,796820,332196,951009,1415633,3495658,18747,6291,251,157,25446
2055,2021-03-02,73.81,816536,394191,855346,1277691,3343764,16289,9501,236,171,26197
2056,2021-03-03,73.97,869985,292330,741730,1319385,3223430,17246,7464,249,156,25115
2057,2021-03-04,74.7,860871,333691,734080,1261260,3189902,17238,7895,228,185,25546
2058,2021-03-05,74.2025,704836,304843,818018,1218011,3045708,16390,5283,259,128,22060
2059,2021-03-09,73.915,717810,383417,863792,1198185,3163204,16395,7435,239,164,24233
2060,2021-03-10,73.6025,764096,476618,853200,1140678,3234592,15601,10210,237,179,26227
2061,2021-03-11,73.3,845756,305512,761311,1301555,3214134,17442,8158,239,177,26016
2062,2021-03-12,73.33,793798,314868,769887,1248817,3127370,16631,8517,234,175,25557
2063,2021-03-15,72.805,829533,407691,742863,1164705,3144792,15734,10780,228,185,26927
2064,2021-03-16,72.85,811429,406283,726176,1131322,3075210,14828,10708,222,186,25944
2065,2021-03-17,73.64,737384,347343,678246,1068287,2831260,17617,5865,266,122,23870
2066,2021-03-18,74.3025,600547,308762,449389,741174,2099872,14467,5426,218,114,20225
2067,2021-03-19,74.115,522412,317047,469986,675351,1984796,13759,5641,222,105,19727
2068,2021-03-22,74.94,587034,439730,667410,814714,2508888,14966,6703,237,116,22022
2069,2021-03-23,76.39,590678,528964,714699,776413,2610754,14410,7941,241,133,22725
2070,2021-03-24,76.5775,549479,473253,682094,758320,2463146,14070,8121,216,147,22554
2071,2021-03-25,76.21,511447,439188,736349,808608,2495592,12101,8279,227,139,20746
2072,2021-03-26,75.655,516517,447062,793322,862777,2619678,10937,8579,215,146,19877
2073,2021-03-29,75.68,501588,432910,808740,877418,2620656,11031,8385,223,135,19774
2074,2021-03-30,75.85,647003,458752,819237,1007488,2932480,14169,8607,237,136,23149
2075,2021-03-31,75.69,545322,573820,892908,864410,2876460,12367,10145,195,164,22871
2076,2021-04-01,76.2575,590103,533692,846420,902831,2873046,14347,8790,234,138,23509
2077,2021-04-02,76.5525,587630,538124,806238,855744,2787736,14423,8975,235,134,23767
2078,2021-04-05,76.39,533371,551090,818938,801219,2704618,12835,9031,208,154,22228
2079,2021-04-06,77.265,664088,610729,814212,867571,2956600,14413,9646,247,138,24444
2080,2021-04-07,76.98,571256,515953,876273,931576,2895058,13239,8737,233,139,22348
2081,2021-04-08,76.855,551545,598198,904747,858094,2912584,12308,11942,215,170,24635
2082,2021-04-09,77.395,682233,530787,847510,998956,3059486,15626,9368,271,136,25401
2083,2021-04-12,77.385,556777,568859,887151,875069,2887856,13320,9671,234,161,23386
2084,2021-04-13,75.94,628215,632533,856836,852518,2970102,12992,10828,220,171,24211
2085,2021-04-14,75.87,629286,564142,851776,916920,2962124,13710,10478,217,168,24573
2086,2021-04-15,76.325,572398,455698,828501,945201,2801798,12748,8406,225,158,21537
2087,2021-04-16,75.8175,534638,456369,888056,966325,2845388,11857,10033,213,163,22266
2088,2021-04-19,76.35,600674,422263,847007,1025418,2895362,13666,8712,238,146,22762
2089,2021-04-20,76.83,681418,500307,823298,1004409,3009432,15763,8001,264,128,24156
2090,2021-04-21,76.6,549028,477330,822012,893710,2742080,13320,8273,233,144,21970
2091,2021-04-22,75.4175,618152,543553,771057,845656,2778418,12931,11227,214,177,24549
2092,2021-04-23,74.98,683742,482543,750688,951887,2868860,14586,10570,221,174,25551
2093,2021-04-26,74.97,686025,410427,712969,988567,2797988,15242,8783,230,160,24415
2094,2021-04-27,74.89,700979,388222,657048,969805,2716054,16045,8569,227,162,25003
2095,2021-04-28,74.4125,748745,568580,711818,891983,2921126,15984,10498,223,193,26898
2096,2021-04-29,74.635,793948,448713,616930,962165,2821756,16702,9606,243,160,26711
2097,2021-04-30,75.21,888765,317340,673589,1245014,3124708,21116,5077,279,116,26588
2098,2021-05-04,74.8425,695758,348127,657994,1005625,2707504,17469,5515,243,148,23375
2099,2021-05-05,74.86,693539,479903,703506,917142,2794090,17560,8433,239,160,26392
2100,2021-05-06,74.23,755274,536101,668468,887641,2847484,17210,9508,223,182,27123
2101,2021-05-07,73.785,831749,503124,632722,961347,2928942,17466,8844,228,177,26715
2102,2021-05-10,74.35,782311,348913,613106,1046504,2790834,18639,6696,243,150,25728
2103,2021-05-11,74.11,791411,327975,591377,1054813,2765576,18777,6483,237,157,25654
2104,2021-05-12,74.63,914962,353917,593775,1154820,3017474,21406,5463,267,131,27267
2105,2021-05-13,74.0775,805870,412351,663574,1057093,2938888,18436,8062,230,169,26897
2106,2021-05-14,74.0125,829692,368662,583926,1044956,2827236,18051,7063,223,190,25527
2107,2021-05-17,73.8,876726,373302,595151,1098575,2943754,18598,6628,246,165,25637
2108,2021-05-18,73.7,874936,469365,604606,1010177,2959084,19325,8802,241,174,28542
2109,2021-05-19,73.79,941755,301718,620884,1260921,3125278,20147,6857,251,161,27416
2110,2021-05-20,73.53,942731,483553,671856,1131034,3229174,19393,9223,248,166,29030
2111,2021-05-21,73.5975,944726,491003,738464,1192187,3366380,19923,8581,247,163,28914
2112,2021-05-24,73.4925,1032401,265823,664906,1431484,3394614,22180,4122,289,117,26708
2113,2021-05-25,73.5,977191,371564,707361,1312988,3369104,19917,6414,255,168,26754
2114,2021-05-26,73.51,1045869,305126,654914,1395657,3401566,20929,5559,274,143,26905
2115,2021-05-27,73.465,949694,366157,754163,1337700,3407714,19992,6470,248,173,26883
2116,2021-05-28,73.15,1046048,412015,715966,1349999,3524028,21264,7625,246,174,29309
2117,2021-05-31,73.43,989232,322940,716500,1382792,3411464,20593,6258,254,153,27258
2118,2021-06-01,73.5075,1056397,334778,635913,1357532,3384620,21940,5609,260,145,27954
2119,2021-06-02,73.16,1003672,398852,710850,1315670,3429044,20732,6107,241,168,27248
2120,2021-06-03,73.24,970241,369409,712185,1313017,3364852,20455,6766,232,164,27617
2121,2021-06-04,72.795,1034547,475723,798103,1356927,3665300,20775,8010,236,162,29183
2122,2021-06-07,72.81,965120,383512,780822,1362430,3491884,20390,6752,240,154,27536
2123,2021-06-08,72.3,1039717,509727,860139,1390129,3799712,20635,8393,236,167,29431
2124,2021-06-09,72.305,954418,386169,810683,1378932,3530202,20092,6910,250,155,27407
2125,2021-06-10,71.77,1010278,461836,893121,1441563,3806798,19941,8639,240,170,28990
2126,2021-06-11,72.13,967106,323708,819743,1463141,3573698,19575,6693,250,171,26689
2127,2021-06-14,72.1025,999505,301473,775680,1473712,3550370,21200,5983,252,162,27597
2128,2021-06-15,72.18,957935,317947,799341,1439329,3514552,19836,5868,253,139,26096
2129,2021-06-16,72.5625,922909,393454,808224,1337679,3462266,19288,7212,243,167,26910
2130,2021-06-17,72.3225,707380,303664,513653,917369,2442066,15720,5480,201,125,21526
2131,2021-06-18,72.85,796174,314516,527852,1009510,2648052,18284,5009,218,122,23633
2132,2021-06-21,73.1325,786512,298366,552852,1040998,2678728,19938,4342,224,125,24629
2133,2021-06-22,72.875,730223,307872,606832,1029183,2674110,18757,4532,233,121,23643
2134,2021-06-23,72.6075,721306,473834,743576,991048,2929764,16904,8684,204,165,25957
2135,2021-06-24,72.305,788232,456321,694556,1026467,2965576,18216,8410,211,167,27004
2136,2021-06-25,72.2025,796416,394559,685755,1087612,2964342,18377,8002,212,164,26755
2137,2021-06-28,72.1175,824811,301542,616683,1139952,2882988,19455,5709,228,150,25542
2138,2021-06-29,72.76,981645,325612,640447,1296480,3244184,21290,5603,253,139,27285
2139,2021-06-30,73.135,888669,319129,682109,1251649,3141556,21533,4600,257,129,26519
2140,2021-07-01,73.4,858391,346784,732755,1244362,3182292,20829,5107,259,130,26325
2141,2021-07-02,73.24,729050,318273,838567,1249344,3135234,19491,4829,232,150,24702
2142,2021-07-05,73.46,743560,329870,823616,1237306,3134352,19861,5203,252,135,25451
2143,2021-07-06,74.4225,775518,434084,922710,1264144,3396456,19087,5893,258,111,25349
2144,2021-07-07,74.7125,718110,473229,973703,1218584,3383626,17219,6231,266,116,23832
2145,2021-07-08,74.7375,660846,472273,1011168,1199741,3344028,16460,7010,240,129,23839
2146,2021-07-09,74.36,634430,510559,1037018,1160889,3342896,15165,8460,215,161,24001
2147,2021-07-12,74.44,609803,435290,1027185,1201698,3273976,15362,6642,221,151,22376
2148,2021-07-13,74.295,612023,451626,987450,1147847,3198946,13697,10425,209,166,24497
2149,2021-07-14,74.075,598848,430305,1000233,1168776,3198162,14042,8519,218,164,22943
2150,2021-07-15,74.365,652320,412016,927501,1167805,3159642,14610,8014,227,154,23005
2151,2021-07-16,74.0725,776495,362241,828369,1242623,3209728,16414,6818,241,131,23604
2152,2021-07-19,74.65,934067,359632,849833,1424268,3567800,19054,5719,273,119,25165
2153,2021-07-20,74.37,847074,323120,892751,1416705,3479650,19108,5560,252,124,25044
2154,2021-07-21,74.015,747643,510886,1081485,1318242,3658256,15568,9457,217,159,25401
2155,2021-07-22,73.7,701946,460421,986667,1228192,3377226,16221,9159,225,147,25752
2156,2021-07-23,73.76,716146,491979,1050724,1274891,3533740,16257,9215,218,158,25848
2157,2021-07-26,73.65,788692,395373,1011634,1404953,3600652,17690,7162,227,148,25227
2158,2021-07-27,73.7325,744110,431259,995745,1308596,3479710,16879,7712,226,148,24965
2159,2021-07-28,73.4775,724997,354825,933942,1304114,3317878,16918,7467,233,157,24775
2160,2021-07-29,73.1525,800685,427431,944175,1317429,3489720,17568,8688,221,172,26649
2161,2021-07-30,73.16,822824,370551,868371,1320644,3382390,17505,7008,230,149,24892
2162,2021-08-02,73.0575,846987,426305,904900,1325582,3503774,18042,8087,227,153,26509
2163,2021-08-03,72.94,880363,293007,859279,1446635,3479284,18265,6647,256,129,25297
2164,2021-08-04,73.17,918508,301132,887229,1504605,3611474,19368,5732,270,127,25497
2165,2021-08-05,73.07,845138,315980,936327,1465485,3562930,18233,6327,253,133,24946
2166,2021-08-06,73.49,945722,310061,923203,1558864,3737850,20242,5178,277,115,25812
2167,2021-08-09,73.665,888410,320537,904195,1472068,3585210,20991,5065,278,117,26451
2168,2021-08-10,73.9175,883990,315075,879868,1448783,3527716,21045,4389,278,113,25825
2169,2021-08-11,73.365,797296,295670,908408,1410034,3411408,19894,4478,262,137,24771
2170,2021-08-12,73.5925,751909,341969,947561,1357501,3398940,17757,6498,241,147,24643
2171,2021-08-13,73.21,809804,395490,977333,1391647,3574274,17922,8323,226,162,26633
2172,2021-08-16,73.2375,798296,382481,942014,1357829,3480620,18109,8101,230,153,26593
2173,2021-08-17,73.57,893845,305433,823457,1411869,3434604,21249,4683,258,130,26320
2174,2021-08-18,73.82,974556,327200,792164,1439520,3533440,21765,4144,282,114,26305
2175,2021-08-19,74.2,946495,355988,766203,1356710,3425396,20458,5001,264,125,25848
2176,2021-08-20,74.26,876349,365857,757261,1267753,3267220,19299,5242,255,126,24922
2177,2021-08-23,74.1225,743171,380339,776670,1139502,3039682,17426,5891,227,145,23689
2178,2021-08-24,73.73,688174,480512,849031,1056693,3074410,15386,8904,211,169,24670
2179,2021-08-25,73.9325,700741,374543,781381,1107579,2964244,16392,6207,233,144,22976
2180,2021-08-26,74.23,846445,322678,704459,1228226,3101808,19411,4406,261,121,24199
2181,2021-08-27,73.53,775120,412798,794380,1156702,3139000,16417,7557,231,162,24367
2182,2021-08-30,73.5,767363,422350,825310,1170323,3185346,16905,7801,217,158,25081
2183,2021-08-31,73.2175,825462,414242,852230,1263450,3355384,18062,7874,217,162,26315
2184,2021-09-01,72.98,871615,428584,908520,1351551,3560270,18294,8120,225,163,26802
2185,2021-09-02,72.87,907674,422055,870815,1356434,3556978,19000,7932,230,166,27328
2186,2021-09-03,72.7225,933244,422851,889387,1399780,3645262,19422,7741,237,160,27560
2187,2021-09-06,72.99,977512,296324,777416,1458604,3509856,22132,4843,256,128,27359
2188,2021-09-07,73.2725,1038981,272300,737373,1504054,3552708,23133,3466,276,120,26995
2189,2021-09-08,73.1475,876645,294228,809117,1391534,3371524,20084,4060,255,143,24542
2190,2021-09-09,72.975,851274,448320,898481,1301435,3499510,18432,7749,228,175,26584
2191,2021-09-10,73.175,882605,327634,741022,1295993,3247254,18854,5277,248,134,24513
2192,2021-09-13,72.655,938966,451884,774497,1261579,3426926,18919,7687,231,175,27012
2193,2021-09-14,72.9,877959,329693,720330,1268596,3196578,18101,6228,229,161,24719
2194,2021-09-15,72.275,929176,424856,888599,1392919,3635550,18310,7444,226,173,26153
2195,2021-09-16,72.5,725530,271197,552794,1007127,2556648,15253,5751,202,136,21342
2196,2021-09-17,72.8525,815543,251997,560590,1124136,2752266,18044,4055,221,119,22439
2197,2021-09-20,73.425,818187,269884,567589,1115892,2771552,19342,3793,242,114,23491
2198,2021-09-21,73.085,776062,236486,534573,1074149,2621270,17796,4068,217,133,22214
2199,2021-09-22,72.9725,776698,341002,609481,1045177,2772358,16981,7608,200,155,24944
2200,2021-09-23,72.8425,769619,321457,637017,1085179,2813272,18350,7015,213,146,25724
2201,2021-09-24,72.7225,809451,232509,631396,1208338,2881694,19867,3966,235,117,24185
2202,2021-09-27,72.53,840371,365806,663783,1138348,3008308,18947,7147,216,151,26461
2203,2021-09-28,72.795,916247,259994,633727,1289980,3099948,19642,5048,238,124,25052
2204,2021-09-29,72.84,868935,245169,618067,1241833,2974004,20636,4361,231,132,25360
2205,2021-09-30,72.735,912981,246765,625443,1291659,3076848,20336,4630,246,127,25339
2206,2021-10-01,72.73,937405,236555,702338,1403188,3279486,21660,3457,264,120,25501
2207,2021-10-04,72.51,898430,350725,791077,1338782,3379014,19743,6800,228,151,26922
2208,2021-10-05,72.37,891591,354604,783147,1320134,3349476,19279,7402,219,155,27055
2209,2021-10-06,72.39,920169,259535,692592,1353226,3225522,19477,5789,227,141,25634
2210,2021-10-07,71.7,1005684,365927,733310,1373067,3477988,20422,6670,229,154,27475
2211,2021-10-08,71.875,971138,340933,706756,1336961,3355788,20506,6585,217,152,27460
2212,2021-10-11,71.865,946303,352340,723323,1317286,3339252,20336,7028,221,155,27740
2213,2021-10-12,71.805,1013444,265210,659034,1407268,3344956,22778,4786,246,135,27945
2214,2021-10-13,71.97,1006711,267770,708351,1447292,3430124,22461,4215,251,128,27055
2215,2021-10-14,71.345,988623,394070,717149,1311702,3411544,20333,6608,220,160,27321
2216,2021-10-15,71.025,1041839,379863,689678,1351654,3463034,20441,6623,225,154,27443
2217,2021-10-18,71.2875,958594,349496,716694,1325792,3350576,20485,5699,248,137,26569
2218,2021-10-19,70.8525,983858,405301,709051,1287608,3385818,20134,7172,226,155,27687
2219,2021-10-20,70.8025,972489,388503,693375,1277361,3331728,20141,6294,227,157,26819
2220,2021-10-21,71.095,1056254,293005,672674,1435923,3457856,23592,3948,281,114,27935
2221,2021-10-22,70.3375,1023055,387051,699637,1335641,3445384,20765,6525,248,154,27692
2222,2021-10-25,69.71,1024787,400146,757553,1382194,3564680,20915,6981,238,159,28293
2223,2021-10-26,69.5025,1013328,364786,729536,1378078,3485728,20968,6875,238,168,28249
2224,2021-10-27,70.6425,1004498,279553,719698,1444643,3448392,23346,3633,270,129,27378
2225,2021-10-28,70.2025,1006560,271694,663896,1398762,3340912,21790,4185,256,134,26365
2226,2021-10-29,70.955,1032884,261845,678967,1450006,3423702,23130,3552,286,112,27080
2227,2021-11-01,71.56,963441,320285,747447,1390603,3421776,22157,4395,283,119,26954
2228,2021-11-02,71.5025,945202,336865,805442,1413779,3501288,20961,4338,258,128,25685
2229,2021-11-03,71.73,871114,352144,862422,1381392,3467072,21392,4523,265,123,26303
2230,2021-11-05,71.255,860385,419056,945337,1386666,3611444,19240,6804,243,148,26435
2231,2021-11-08,71.2025,834713,399837,872430,1307306,3414286,18727,7692,233,155,26807
2232,2021-11-09,70.755,922336,455913,781968,1248391,3408608,19266,7725,224,171,27386
2233,2021-11-10,71.3,909544,334645,758421,1333320,3335930,19269,5810,230,160,25469
2234,2021-11-11,71.63,871951,316313,765715,1321353,3275332,19863,5598,247,143,25851
2235,2021-11-12,72.8875,779329,392124,923363,1310568,3405384,19857,5072,280,120,25329
2236,2021-11-15,72.5,728635,399631,954132,1283136,3365534,19322,4805,260,128,24515
2237,2021-11-16,73.13,729877,500818,1006372,1235431,3472498,18968,6478,265,132,25843
2238,2021-11-17,72.5,685954,444847,965786,1206893,3303480,17520,6979,248,157,24904
2239,2021-11-18,73.05,712006,434773,1049712,1326945,3523436,18722,5715,280,129,24846
2240,2021-11-19,73.445,710571,458161,1026639,1279049,3474420,17977,5358,281,122,23738
2241,2021-11-22,74.82,584568,612982,1042482,1014068,3254100,15572,7863,261,139,23835
2242,2021-11-23,74.27,526704,634969,1141023,1032758,3335454,14445,9768,241,166,24620
2243,2021-11-24,74.99,536941,609535,1082000,1009406,3237882,13982,9311,235,159,23687
2244,2021-11-25,74.68,462459,621628,1176982,1017813,3278882,13485,9290,228,162,23165
2245,2021-11-26,75.605,532548,583253,1084183,1033478,3233462,13614,7957,225,148,21944
2246,2021-11-29,74.6,460405,581146,1152727,1031986,3226264,11809,8407,201,169,20586
2247,2021-11-30,74.065,488459,572771,1090585,1006273,3158088,11965,8538,200,171,20874
2248,2021-12-01,74.2775,509456,495993,1027165,1040628,3073242,12868,8236,221,157,21482
2249,2021-12-02,73.64,561099,450754,962412,1072757,3047022,13341,7212,219,158,20930
2250,2021-12-03,73.8325,555755,387892,927916,1095779,2967342,13350,6494,228,159,20231
2251,2021-12-06,74.31,611803,320771,815946,1106978,2855498,14939,5147,256,131,20473
2252,2021-12-07,74.06,582087,369647,879338,1091778,2922850,13973,5776,257,132,20138
2253,2021-12-08,73.5875,539953,405549,886124,1020528,2852154,13099,7569,237,155,21060
2254,2021-12-09,73.685,535289,378655,878108,1034742,2826794,13305,6429,232,155,20121
2255,2021-12-10,73.3725,547780,424302,817992,941470,2731544,12138,8414,222,175,20949
2256,2021-12-13,73.4975,581641,331529,672368,922480,2508018,13515,6987,246,155,20903
2257,2021-12-14,73.8,616493,309143,644880,952230,2522746,13931,6335,241,147,20654
2258,2021-12-15,73.71,640870,301870,612617,951617,2506974,15060,4208,268,132,19668
2259,2021-12-16,73.7525,364151,336889,630257,657519,1988816,8429,6331,180,138,15078
2260,2021-12-17,74.13,487736,314769,594455,767422,2164382,10549,5372,201,123,16245
2261,2021-12-20,74.145,504937,313671,598111,789377,2206096,11064,5062,200,127,16453
2262,2021-12-21,73.9525,455364,323225,635067,767206,2180862,10746,5938,192,129,17005
2263,2021-12-22,73.74,445624,414789,692017,722852,2275282,9934,7549,166,149,17798
2264,2021-12-23,73.3,487428,359551,599757,727634,2174370,10563,7836,170,153,18722
2265,2021-12-24,73.65,532455,307056,510507,735906,2085924,11183,5924,190,134,17431
2266,2021-12-27,73.4325,555591,297652,517672,775611,2146526,10912,6212,190,136,17450
2267,2021-12-28,73.7175,630603,287156,516783,860230,2294772,13015,4504,200,122,17841
2268,2021-12-29,73.9925,623483,312603,602879,913759,2452724,12474,4497,207,115,17293
2269,2021-12-30,74.68,546432,408353,655761,793840,2404386,11848,5322,211,121,17502
2270,2022-01-03,74.5425,479953,414594,682564,747923,2325034,11265,5218,187,141,16811
2271,2022-01-04,75.3625,509487,544911,783232,747808,2585438,11938,7689,206,136,19969
2272,2022-01-05,76.8,495615,579555,809645,725705,2610520,11501,8320,188,132,20141
2273,2022-01-06,76.3175,402003,687735,982227,696495,2768460,9459,10772,194,137,20562
2274,2022-01-07,75.75,459849,588341,838340,709848,2596378,9728,10022,192,142,20084
2275,2022-01-10,75.0,465191,574687,927847,818351,2786076,11688,9110,195,146,21139
2276,2022-01-11,74.45,511506,542676,848632,817462,2720276,11707,8983,188,161,21039
2277,2022-01-12,74.7075,545045,494191,781197,832051,2652484,12076,8312,194,158,20740
2278,2022-01-13,76.2575,591730,609705,874537,856562,2932534,12687,8269,232,127,21315
2279,2022-01-14,76.21,585884,553968,899415,931331,2970598,11720,8330,233,133,20416
2280,2022-01-17,76.0925,532932,535741,905622,902813,2877108,10290,8411,235,135,19071
2281,2022-01-18,76.91,583236,558346,848867,873757,2864206,11399,8852,240,134,20625
2282,2022-01-19,76.1775,483532,529177,836173,790528,2639410,9276,9120,187,158,18741
2283,2022-01-20,76.6825,413098,508916,876867,781049,2579930,9640,8662,203,144,18649
2284,2022-01-21,77.425,428895,575617,908954,762232,2675698,10585,9987,226,141,20939
2285,2022-01-24,78.7625,449401,598002,1010039,861438,2918880,9931,11717,214,151,22013
2286,2022-01-25,78.6325,420460,572549,1056302,904213,2953524,9655,11320,210,155,21340
2287,2022-01-26,79.4175,444911,637598,1170888,978201,3231598,10187,12376,218,159,22940
2288,2022-01-27,77.96,428344,495554,1018030,950820,2892748,8739,12013,173,171,21096
2289,2022-01-28,77.8,402146,455470,907951,854627,2620194,8231,11324,172,158,19885
2290,2022-01-31,77.315,399961,431538,888347,856770,2576616,8311,10941,189,160,19601
2291,2022-02-01,76.805,470538,421900,832188,880826,2605452,9354,10229,184,160,19927
2292,2022-02-02,76.04,487995,392070,777736,873661,2531462,10148,9652,188,155,20143
2293,2022-02-03,76.4475,474800,373028,751266,853038,2452132,10886,8939,192,148,20165
2294,2022-02-04,75.83,457714,382764,776778,851728,2468984,10347,9693,194,149,20383
2295,2022-02-07,75.475,496302,376600,779014,898716,2550632,11264,8957,201,153,20575
2296,2022-02-08,75.0075,522242,382682,768532,908092,2581548,11101,9127,183,159,20570
2297,2022-02-09,74.74,556112,383370,792770,965512,2697764,11994,8926,186,161,21267
2298,2022-02-10,75.01,613504,306368,801154,1108290,2829316,13063,7360,210,151,20784
2299,2022-02-11,77.1675,621051,311725,848834,1158160,2939770,14380,6203,242,115,20940
2300,2022-02-14,76.76,477302,358560,828640,947382,2611884,10904,7394,221,128,18647
2301,2022-02-15,75.3125,442547,363507,846474,925514,2578042,9472,8239,175,149,18035
2302,2022-02-16,75.2525,466674,324003,805913,948584,2545174,10665,7802,193,137,18797
2303,2022-02-17,76.2825,521013,314693,787573,993893,2617172,12187,6342,220,114,18863
2304,2022-02-18,77.3,611729,289157,768611,1091183,2760680,13761,6051,245,108,20165
2305,2022-02-21,79.78,594219,348041,938048,1184226,3064534,13143,7584,245,121,21093
2306,2022-02-22,78.8,529854,345583,1004324,1188595,3068356,11877,7889,211,141,20118
2307,2022-02-23,81.16,521692,406917,1152613,1267388,3348610,11389,9586,230,130,21335
2308,2022-02-24,85.25,465454,224247,1102025,1343232,3134958,11234,5512,194,112,17052
2309,2022-02-25,83.0,414401,161143,1021294,1274552,2871390,10592,4832,200,116,15740
2310,2022-02-28,94.6025,432738,158075,994576,1269239,2854628,10480,4342,202,111,15135
2311,2022-03-01,101.2325,432738,158075,994576,1269239,2854628,10480,4342,202,111,15135
2312,2022-03-02,106.02,283730,83640,880842,1080932,2329144,7067,2078,182,76,9403
2313,2022-03-03,106.01,253872,70546,837049,1020375,2181842,6240,1805,168,71,8284
2314,2022-03-04,105.0,229898,64274,808635,974259,2077066,5875,1680,164,63,7782
2315,2022-03-09,120.0,209035,68142,740249,881142,1898568,6636,2209,165,60,9070
2316,2022-03-10,118.5,218919,71876,736562,883605,1910962,7259,2259,164,57,9739
2317,2022-03-11,114.2525,229592,72204,729316,886704,1917816,7144,2239,163,56,9602
2318,2022-03-14,114.1025,222830,92909,731352,861273,1908364,7187,3067,158,66,10478
2319,2022-03-15,110.1,235512,95309,714235,854438,1899494,7702,3057,154,64,10977
2320,2022-03-16,108.0,214734,114553,757968,858149,1945404,7161,3544,139,59,10903
2321,2022-03-17,103.15,128708,57177,382108,453639,1021632,3528,3062,84,46,6720
2322,2022-03-18,104.82,136999,56424,393407,473982,1060812,3931,3151,92,43,7217
2323,2022-03-21,104.0,150605,63576,395510,482539,1092230,4968,3916,95,45,9024
2324,2022-03-22,103.55,150048,67679,395313,477682,1090722,5004,3975,92,45,9116
2325,2022-03-23,97.7375,157041,74479,399091,481653,1112264,5787,4097,90,51,10025
2326,2022-03-24,97.0,173542,68954,396343,500931,1139770,6962,3754,100,46,10862
2327,2022-03-25,96.0,184100,73450,404156,514806,1176512,6992,3355,115,42,10504
2328,2022-03-28,89.75,227147,77593,414031,563585,1282356,9286,3845,123,45,13299
2329,2022-03-29,85.25,231535,90321,412740,553954,1288550,10199,3920,127,40,14286
2330,2022-03-30,84.55,274539,91224,421628,604943,1392334,11785,4267,133,41,16226
2331,2022-03-31,83.2,287439,86562,413864,614741,1402606,12384,4305,138,47,16874
2332,2022-04-01,83.95,294726,77408,411609,628927,1412670,13510,3539,145,42,17236
2333,2022-04-04,84.0,307225,85262,414248,636211,1442946,15089,3526,139,49,18803
2334,2022-04-05,83.3125,316896,81265,410824,646455,1455440,15755,3649,144,47,19595
2335,2022-04-06,79.7,354861,92780,431116,693197,1571954,16339,3771,141,58,20309
2336,2022-04-07,75.75,369672,98741,453015,723946,1645374,17871,4007,145,51,22074
2337,2022-04-08,76.08,376644,96436,459198,739406,1671684,17772,3808,147,59,21786
2338,2022-04-11,79.065,379673,111385,471072,739360,1701490,19064,4467,156,60,23747
2339,2022-04-12,79.68,378078,101687,465114,741505,1686384,18999,4451,159,54,23663
2340,2022-04-13,79.8675,391431,90961,463198,763668,1709258,18853,4125,153,55,23186
2341,2022-04-14,80.8975,404764,95470,460576,769870,1730680,20296,3762,162,54,24274
2342,2022-04-15,79.995,397451,102338,465801,760914,1726504,19778,4695,161,61,24695
2343,2022-04-18,79.75,390701,109060,465319,746960,1712040,19561,5267,156,63,25047
2344,2022-04-19,78.515,389139,107355,467088,748872,1712454,18580,5026,154,68,23828
2345,2022-04-20,76.4125,405978,105850,462598,762726,1737152,19842,4486,153,67,24548
2346,2022-04-21,74.785,432125,96687,471411,806849,1807072,21021,4163,154,72,25410
2347,2022-04-22,75.45,455978,65367,492772,883383,1897500,21450,2919,177,56,24602
2348,2022-04-25,73.125,541105,66380,484272,958997,2050754,25201,3153,174,65,28593
2349,2022-04-26,73.525,547807,67466,484008,964349,2063630,24066,3411,176,65,27718
2350,2022-04-27,72.78,577987,65179,494873,1007681,2145720,24647,3127,185,60,28019
2351,2022-04-28,72.08,615892,85455,495382,1025819,2222548,25424,4012,175,71,29682
2352,2022-04-29,70.96,662173,74077,499476,1087572,2323298,25784,3254,180,71,29289
2353,2022-05-04,66.3,693158,79597,510431,1123992,2407178,25413,4149,184,71,29817
2354,2022-05-05,67.0,698408,84650,509790,1123548,2416396,26116,4182,192,73,30563
2355,2022-05-06,69.4025,690938,69286,538341,1159993,2458558,25136,3464,209,53,28862
2356,2022-05-11,67.2,675275,97696,682447,1260026,2715444,25078,4367,192,80,29717
2357,2022-05-12,63.3,678586,110579,835619,1403626,3028410,24317,4923,190,86,29516
2358,2022-05-13,64.545,660127,107682,840359,1392804,3000972,23474,4742,197,72,28485
2359,2022-05-16,63.4,651771,122173,864464,1394062,3032470,24055,5516,192,76,29839
2360,2022-05-17,63.6,681029,111577,1018247,1587699,3398552,26258,5162,202,73,31695
2361,2022-05-18,63.445,675739,115031,1016342,1577050,3384162,26213,4688,194,82,31177
2362,2022-05-19,61.905,662652,163306,1137748,1637094,3600800,25069,5720,196,85,31070
2363,2022-05-20,60.2325,661044,131327,1359740,1889457,4041568,24155,4406,211,75,28847
2364,2022-05-23,57.8675,724925,161293,1465887,2029519,4381624,27399,5285,199,96,32979
2365,2022-05-24,56.8,729172,187680,1593577,2135069,4645498,26790,6077,204,105,33176
2366,2022-05-25,59.33,815779,177590,1708607,2346796,5048772,27597,5645,231,92,33565
2367,2022-05-26,65.26,748032,142813,1637435,2242654,4770934,25308,5334,241,81,30964
2368,2022-05-27,66.7,716854,168890,1449828,1997792,4333364,23478,5409,227,82,29196
2369,2022-05-30,62.25,829443,182314,1503675,2150804,4666236,28903,4900,226,101,34130
2370,2022-05-31,61.5,849065,152595,1503838,2200308,4705806,29365,4688,224,101,34378
2371,2022-06-01,61.28,860947,167015,1558994,2252926,4839882,29786,5023,227,106,35142
2372,2022-06-02,61.65,882639,147651,1655157,2390145,5075592,30403,4371,234,108,35116
2373,2022-06-03,60.95,865529,202859,1722368,2385038,5175794,29046,5145,237,106,34534
2374,2022-06-06,61.0175,828983,201181,1762662,2390464,5183290,27992,6131,234,98,34455
2375,2022-06-07,61.0425,851178,197678,1712090,2365590,5126536,28557,6066,240,105,34968
2376,2022-06-08,59.4,877918,220709,1827025,2484234,5409886,30511,6439,236,116,37302
2377,2022-06-09,59.35,892689,192325,1802109,2502473,5389596,31051,5723,248,103,37125
2378,2022-06-10,56.8,962865,196024,1795766,2562607,5517262,32041,5250,237,114,37642
2379,2022-06-14,56.6,857131,223943,1924419,2557607,5563100,27930,6707,233,112,34982
2380,2022-06-15,56.96,807469,210054,2068747,2666162,5752432,25806,7001,239,100,33146
2381,2022-06-16,56.5,534773,193874,1850188,2191087,4769922,18714,5977,158,101,24950
2382,2022-06-17,56.41,512243,219608,1957942,2250577,4940370,17059,6186,170,108,23523
2383,2022-06-20,55.63,537440,250190,1995024,2282274,5064928,20320,7283,170,122,27895
2384,2022-06-21,53.775,535011,358653,2330896,2507254,5731814,19056,9138,167,137,28498
2385,2022-06-22,53.15,572518,355089,2496154,2713583,6137344,19494,9157,174,138,28963
2386,2022-06-23,53.465,585182,337206,2652374,2900350,6475112,19695,9402,175,130,29402
2387,2022-06-24,53.4,614541,264040,2716516,3067017,6662114,20433,7515,182,122,28252
2388,2022-06-27,53.385,633450,301313,2813841,3145978,6894582,20881,8195,187,127,29390
2389,2022-06-28,51.8,596588,299685,2930006,3226909,7053188,19654,8659,185,119,28617
2390,2022-06-29,53.2375,638131,226803,3022277,3433605,7320816,20809,6975,200,103,28087
2391,2022-06-30,51.45,639317,221027,3118235,3536525,7515104,22257,6429,195,105,28986
2392,2022-07-01,54.5,624297,180232,3151417,3595482,7551428,20935,5711,216,94,26956
2393,2022-07-04,55.24,637716,225327,3117828,3530217,7511088,21867,6501,204,101,28673
2394,2022-07-05,61.15,574153,286300,3072807,3360660,7293920,19164,9743,217,90,29214
2395,2022-07-06,63.35,552020,263050,2855736,3144706,6815512,19598,8949,218,87,28852
2396,2022-07-07,61.95,517890,276084,2816546,3058352,6668872,18171,10720,197,110,29198
2397,2022-07-08,60.92,493409,283245,2815955,3026119,6618728,16828,10648,185,113,27774
2398,2022-07-11,58.9,533035,269170,2807650,3071515,6681370,18084,10410,175,131,28800
2399,2022-07-12,58.94,539308,294501,2812317,3057124,6703250,17869,10530,173,141,28713
2400,2022-07-13,58.27,566359,275125,2803397,3094631,6739512,19360,10050,180,130,29720
2401,2022-07-14,58.3,602102,279836,2799085,3121351,6802374,20340,10512,203,121,31176
2402,2022-07-15,57.165,623759,290519,2794500,3127740,6836518,20556,9716,195,134,30601
2403,2022-07-18,56.34,611734,326409,2833738,3119063,6890944,21665,10458,208,125,32456
2404,2022-07-19,55.4525,653355,339151,2842088,3156292,6990886,23531,9390,209,133,33263
2405,2022-07-20,55.02,680951,345442,2854698,3190207,7071298,24003,9846,214,119,34182
2406,2022-07-21,56.6475,798278,261902,2757717,3294093,7111990,25648,6938,244,101,32931
2407,2022-07-22,57.29,810349,233275,2720289,3297363,7061276,25223,5776,237,106,31342
2408,2022-07-25,58.11,858853,258719,2740208,3340342,7198122,25766,6974,251,113,33104
2409,2022-07-26,60.55,907358,255955,2804755,3456158,7424226,25615,7418,258,110,33401
2410,2022-07-27,59.88,911428,226128,2768699,3453999,7360254,26947,6431,252,109,33739
2411,2022-07-28,60.82,928060,227154,2801316,3502222,7458752,25469,7251,262,100,33082
2412,2022-07-29,61.62,928988,200170,2765561,3494379,7389098,25824,6882,276,90,33072
2413,2022-08-01,60.17,906892,246917,2781425,3441400,7376634,25368,8315,235,119,34037
2414,2022-08-02,60.295,903205,224901,2746803,3425107,7300016,25464,7228,235,114,33041
2415,2022-08-03,60.58,890540,252962,2746874,3384452,7274828,25967,7891,246,101,34205
2416,2022-08-04,60.35,891661,267607,2780262,3404316,7343846,26648,8184,244,121,35197
2417,2022-08-05,60.58,894771,230776,2931258,3595253,7652058,26881,6265,265,101,33512
2418,2022-08-08,60.755,795262,244499,2958614,3509377,7507752,24387,7339,245,105,32076
2419,2022-08-09,60.1475,819488,242481,2942013,3519020,7523002,25364,7027,238,117,32746
2420,2022-08-10,60.665,827353,191436,2886571,3522488,7427848,25072,6344,246,104,31766
2421,2022-08-11,60.67,840486,206513,2921712,3555685,7524396,25360,6770,263,97,32490
2422,2022-08-12,60.605,850582,254182,2935463,3531863,7572090,26091,7561,241,126,34019
2423,2022-08-15,61.225,834367,245214,2953786,3542939,7576306,24403,7662,270,88,32423
2424,2022-08-16,60.9,792376,247365,2958772,3503783,7502296,23934,7396,246,109,31685
2425,2022-08-17,60.75,804444,274853,2992014,3521605,7592916,24714,7971,248,124,33057
2426,2022-08-18,59.5325,807849,281778,2986664,3512735,7589026,24944,8360,235,117,33656
2427,2022-08-19,59.1,766614,310006,3006248,3462856,7545724,23236,9075,251,114,32676
2428,2022-08-22,59.87,794747,260517,2955500,3489730,7500494,24135,7954,243,109,32441
2429,2022-08-23,59.89,796056,256185,2933573,3473444,7459258,23860,7833,246,99,32038
2430,2022-08-24,59.8875,820192,243694,2870031,3446529,7380446,24442,7778,254,94,32568
2431,2022-08-25,60.145,896608,207015,2892378,3581971,7577972,24995,6904,270,104,32273
2432,2022-08-26,60.5,846404,189633,2858427,3515198,7409662,25040,6299,272,96,31707
2433,2022-08-29,60.3975,853538,172432,2810370,3491476,7327816,26186,5715,270,90,32261
2434,2022-08-30,59.94,902415,151819,2814183,3564779,7433196,26699,4797,274,85,31855
2435,2022-08-31,60.23,836385,170856,2783691,3449220,7240152,24319,6080,261,84,30744
2436,2022-09-01,60.31,852275,168723,2768724,3452276,7241998,24878,5350,260,96,30584
2437,2022-09-02,60.58,902509,161032,2752910,3494387,7310838,25436,5020,279,92,30827
2438,2022-09-05,60.87,871479,163763,2769270,3476986,7281498,27471,4488,277,81,32317
2439,2022-09-06,61.235,899604,163730,2761802,3497676,7322812,27093,4793,284,89,32259
2440,2022-09-07,60.79,878701,196281,2775680,3458100,7308762,27295,5072,289,92,32748
2441,2022-09-08,60.73,894190,247594,2797155,3443751,7382690,27688,6166,278,105,34237
2442,2022-09-09,60.6,927386,254571,2653422,3326237,7161616,27671,6387,256,114,34428
2443,2022-09-12,60.24,938330,278635,2596730,3256425,7070120,26872,6610,257,114,33853
2444,2022-09-13,59.9,920653,253770,2517531,3184414,6876368,26041,5988,248,114,32391
2445,2022-09-14,59.885,902318,205989,2460460,3156789,6725556,25413,5860,242,117,31632
2446,2022-09-15,59.8,786229,124008,2292354,2954575,6157166,20299,4340,180,104,24923
2447,2022-09-16,60.275,827954,126199,2225862,2927617,6107632,21892,3818,193,92,25995
2448,2022-09-19,60.16,871644,158933,2183565,2896276,6110418,23309,5068,188,112,28677
2449,2022-09-20,60.6,916533,177474,2390315,3129374,6613696,23762,4229,210,90,28291
2450,2022-09-21,60.69,898046,158665,2430627,3170008,6657346,23181,3277,221,88,26767
2451,2022-09-22,58.84,911131,186614,2459328,3183845,6740918,22406,5168,210,109,27893
2452,2022-09-23,57.92,942290,180668,2547652,3309274,6979884,21591,5123,206,101,27021
2453,2022-09-26,58.395,897109,170797,2493251,3219563,6780720,20379,5251,212,96,25938
2454,2022-09-27,58.4575,902044,140660,2492504,3253888,6789096,20295,4143,214,85,24737
2455,2022-09-28,57.54,945695,191538,2508048,3262205,6907486,20621,5349,202,94,26266
2456,2022-09-29,57.21,889420,191131,2523500,3221789,6825840,19214,5246,193,86,24739
2457,2022-09-30,58.45,637161,83800,2611192,3164553,6496706,15656,3831,179,73,19739
2458,2022-10-03,58.86,612465,83239,2613240,3142466,6451410,15855,3909,188,78,20030
2459,2022-10-04,58.95,623986,75606,2608699,3157079,6465370,16341,3739,182,70,20332
2460,2022-10-05,60.1725,642832,94738,2565589,3113683,6416842,16735,4244,182,85,21246
2461,2022-10-06,60.9025,644235,88865,2560457,3115827,6409384,17557,3744,188,77,21566
2462,2022-10-07,61.0025,678634,91998,2524358,3110994,6405984,17757,4306,203,77,22343
2463,2022-10-10,62.69,649529,74014,2542060,3117575,6383178,16723,3443,198,67,20431
2464,2022-10-11,63.66,687568,81466,2529985,3136087,6435106,19569,3326,204,77,23176
2465,2022-10-12,64.42,688290,82263,2501133,3107160,6378846,19447,4050,225,68,23790
2466,2022-10-13,63.63,670261,98313,2526472,3098420,6393466,18696,4762,220,72,23750
2467,2022-10-14,62.1075,604327,108495,2558984,3054816,6326622,17083,3890,213,73,21259
2468,2022-10-17,61.65,604300,148790,2569346,3024856,6347292,17552,5434,201,80,23267
2469,2022-10-18,61.575,599860,123981,2553697,3029576,6307114,17242,4471,212,64,21989
2470,2022-10-19,61.735,603862,161473,2545791,2988180,6299306,16742,5264,195,81,22282
2471,2022-10-20,61.4,628867,132470,2526622,3023019,6310978,17399,4715,209,67,22390
2472,2022-10-21,61.29,605268,126728,2531473,3010013,6273482,16203,4235,194,82,20714
2473,2022-10-24,61.185,653347,122199,2523492,3054640,6353678,17179,4083,204,76,21542
2474,2022-10-25,61.4875,675053,131386,2509207,3052874,6368520,17075,4612,225,70,21982
2475,2022-10-26,61.75,654363,116229,2529711,3067845,6368148,16887,3797,213,79,20976
2476,2022-10-27,61.725,654263,113148,2518435,3059550,6345396,16594,3980,226,82,20882
2477,2022-10-28,61.52,669794,119081,2503316,3054029,6346220,16657,3992,223,73,20945
2478,2022-10-31,61.4775,636216,131821,2510852,3015247,6294136,16756,4430,211,86,21483
2479,2022-11-01,61.2375,625694,155629,2523933,2993998,6299254,16123,5102,209,90,21524
2480,2022-11-02,61.8,635771,128461,2515813,3023123,6303168,15677,4474,213,78,20442
2481,2022-11-03,62.1,596589,125565,2553660,3024684,6300498,15366,4069,202,80,19717
2482,2022-11-07,61.0,634420,171510,2547160,3010070,6363160,16781,5350,197,102,22430
2483,2022-11-08,60.9925,611578,156875,2550534,3005237,6324224,15976,5386,202,110,21674
2484,2022-11-09,61.31,663680,128410,2515137,3050407,6357634,16665,4466,229,86,21446
2485,2022-11-10,60.53,645930,167006,2539494,3018418,6370848,16037,5516,206,104,21863
2486,2022-11-11,60.5375,678177,147535,2543182,3073824,6442718,16162,5244,213,92,21711
2487,2022-11-14,60.55,656740,121263,2546565,3082042,6406610,15636,4523,215,90,20464
2488,2022-11-15,60.4,654061,141264,2561577,3074374,6431276,15765,4760,207,91,20823
2489,2022-11-16,60.35,648401,129368,2555416,3074449,6407634,15502,4438,198,100,20238
2490,2022-11-17,60.53,688819,116493,2528561,3100887,6434760,16675,4269,218,86,21248
2491,2022-11-18,60.4025,702677,105129,2549256,3146804,6503866,16354,3696,231,84,20365
2492,2022-11-21,60.85,681454,104976,2547945,3124423,6458798,16363,3620,215,87,20285
2493,2022-11-22,60.6825,669230,171253,2567328,3065305,6473116,15298,5496,213,99,21106
2494,2022-11-23,60.7,660512,116923,2531823,3075412,6384670,15736,3999,217,91,20043
2495,2022-11-24,60.6725,641674,99242,2627814,3170246,6538976,15071,3628,208,92,18999
2496,2022-11-25,60.5025,688172,108690,2579667,3159149,6535678,15323,4267,218,102,19910
2497,2022-11-28,61.2275,745692,83897,2554968,3216763,6601320,16641,4025,220,89,20975
2498,2022-11-29,61.0225,720062,85752,2601041,3235351,6642206,16155,3568,222,81,20026
2499,2022-11-30,60.99,719202,95089,2622295,3246408,6682994,16076,3685,227,81,20069
2500,2022-11-30,60.99,719202,95089,2622295,3246408,6682994,16076,3685,227,81,20069
2501,2022-12-01,61.49,769073,100389,2598931,3267615,6736008,16640,3754,238,74,20706
2502,2022-12-02,62.0,754396,109036,2607526,3252886,6723844,16061,4136,235,76,20508
2503,2022-12-05,62.35,762589,106005,2585248,3241832,6695674,16511,3989,242,77,20819
2504,2022-12-06,63.085,730756,111696,2555898,3174958,6573308,15659,3906,230,85,19880
2505,2022-12-07,62.75,751979,116055,2544768,3180692,6593494,15610,3868,226,84,19788
2506,2022-12-08,62.7725,696011,150591,2490848,3036268,6373718,14813,5133,220,83,20249
2507,2022-12-09,62.43,734781,122423,2423097,3035455,6315756,15050,4629,220,98,19997
2508,2022-12-12,62.8,812117,115613,2374536,3071040,6373306,17095,3997,246,89,21427
2509,2022-12-13,62.85,757277,114531,2389759,3032505,6294072,15672,3643,236,93,19644
2510,2022-12-14,63.995,740522,144908,2390379,2985993,6261802,15654,4387,229,86,20356
2511,2022-12-15,64.3525,547967,81666,2107680,2573981,5311294,11433,3182,176,65,14856
2512,2022-12-16,64.65,566046,114552,2126831,2578325,5385754,12239,4183,185,61,16668
2513,2022-12-19,67.72,546273,187396,2270929,2629806,5634404,12553,6144,196,73,18966
2514,2022-12-20,68.875,544759,188541,2394484,2750702,5878486,11893,6927,196,77,19093
2515,2022-12-21,70.995,534650,192958,2431456,2773148,5932212,11974,7298,205,84,19561
2516,2022-12-22,68.95,475862,175212,2504216,2804866,5960156,10310,7857,180,94,18441
2517,2022-12-23,70.2,473048,161408,2533502,2845142,6013100,10401,7034,186,88,17709
2518,2022-12-26,69.29,528414,149979,2494985,2873420,6046798,12009,6696,192,84,18981
2519,2022-12-27,70.4,554725,167872,2501902,2888755,6113254,13579,6708,203,82,20572
2520,2022-12-28,72.19,524408,221419,2477557,2780546,6003930,13223,7635,186,85,21129
2521,2022-12-29,72.175,450164,186790,2599769,2863143,6099866,11795,7006,187,76,19064
2522,2022-12-30,69.9,424561,232428,2717376,2909509,6283874,10745,7093,156,107,18101
2523,2023-01-03,71.1375,445537,249065,2718626,2915098,6328326,11727,6791,182,95,18795
2524,2023-01-04,72.0,444963,249882,2715775,2910856,6321476,11869,6920,182,86,19057
2525,2023-01-05,72.18,445282,254860,2724980,2915402,6340524,11961,7298,182,88,19529
2526,2023-01-06,72.1225,428111,240427,2724531,2912215,6305284,10489,6928,169,91,17677
2527,2023-01-09,69.99,476890,259104,2750783,2968569,6455346,12815,8225,158,130,21328
2528,2023-01-10,69.8,493979,225743,2752023,3020259,6492004,13470,7363,163,117,21113
2529,2023-01-11,68.7325,499765,282580,2807809,3024994,6615148,13221,9065,161,133,22580
2530,2023-01-12,67.7575,526438,265510,2819638,3080566,6692152,13719,8972,168,130,22989
2531,2023-01-13,68.7875,562317,215137,2792279,3139459,6709192,15552,5933,186,112,21783
2532,2023-01-16,68.43,591545,212296,2779926,3159175,6742942,16056,6144,186,114,22500
2533,2023-01-17,69.15,607116,216806,2790779,3181089,6795790,16723,5393,188,113,22417
2534,2023-01-18,68.7475,577397,219456,2727076,3085017,6608946,15138,6288,176,113,21715
2535,2023-01-19,68.8,573018,218934,2674145,3028229,6494326,14863,5874,174,116,21027
2536,2023-01-20,68.83,601349,211422,2649628,3039555,6501954,15164,5627,183,111,21085
2537,2023-01-23,68.925,597048,219325,2617689,2995412,6429474,14894,5818,183,118,21013
2538,2023-01-24,69.0,651095,202168,2582540,3031467,6467270,16502,5093,197,109,21901
2539,2023-01-25,69.305,726906,217213,2496715,3006408,6447242,16610,5193,207,105,22115
2540,2023-01-26,69.265,706928,234158,2517402,2990172,6448660,15662,5768,214,105,21749
2541,2023-01-27,69.46,767430,194922,2644353,3216861,6823566,15601,4876,206,108,20791
2542,2023-01-30,70.405,808971,209316,2646299,3245954,6910540,16945,5174,222,108,22449
2543,2023-01-31,69.82,839299,199801,2799679,3439177,7277956,15787,4970,198,111,21066
2544,2023-02-01,70.1975,844099,206559,2792001,3429541,7272200,16162,5122,201,106,21591
2545,2023-02-02,70.455,859216,202863,2802397,3458750,7323226,15777,4911,206,107,21001
2546,2023-02-03,70.6,862033,208648,2983727,3637112,7691520,16082,4548,216,110,20956
2547,2023-02-06,70.95,879528,221780,2981123,3638871,7721302,16693,4825,221,110,21849
2548,2023-02-07,71.15,877159,209768,2976078,3643469,7706474,16856,4819,223,107,22005
2549,2023-02-08,72.3025,868997,258011,2885009,3495995,7508012,16026,5556,237,92,21911
2550,2023-02-09,73.0,838358,265448,2608150,3181060,6893016,15540,5574,250,87,21451
2551,2023-02-10,73.39,861087,253775,2430096,3037408,6582366,15317,5294,261,78,20950
2552,2023-02-13,73.825,946944,242647,2283955,2988252,6461798,17045,5146,272,67,22530
2553,2023-02-14,73.8,909843,273531,2282703,2919015,6385092,15603,6108,254,86,22051
2554,2023-02-15,74.5725,989927,256724,2109347,2842550,6198548,17375,5085,285,67,22812
2555,2023-02-16,74.855,885628,289997,2136508,2732139,6044272,15130,6322,248,82,21782
2556,2023-02-17,74.29,869935,313160,1843446,2400221,5426762,12916,7565,242,102,20825
2557,2023-02-20,74.5,899802,293209,1953084,2559677,5705772,13629,6181,252,81,20143
2558,2023-02-21,75.0475,850590,309704,2055689,2596575,5812558,13793,6888,248,80,21009
2559,2023-02-22,75.0,899396,314643,2052626,2637379,5904044,14877,6867,256,79,22079
2560,2023-02-24,76.13,904263,329395,2058682,2633550,5925890,14087,7069,252,82,21490
2561,2023-02-27,74.6025,883631,319728,2086504,2650407,5940270,12905,7714,237,95,20951
2562,2023-02-28,74.97,931571,288636,2144864,2787799,6152870,14583,6694,244,95,21616
2563,2023-03-01,75.15,953675,264789,2134897,2823783,6177144,14087,6900,251,97,21335
2564,2023-03-02,75.3175,948324,266116,2158170,2840378,6212988,13391,7253,251,102,20997
2565,2023-03-03,75.6325,917148,267979,2205489,2854658,6245274,12209,6944,247,96,19496
2566,2023-03-06,75.445,890745,273314,2208807,2826238,6199104,11936,7081,244,112,19373
2567,2023-03-07,76.0225,909287,297482,2222216,2834021,6263006,13222,7390,259,107,20978
2568,2023-03-09,75.845,892761,323783,2200417,2769395,6186356,13292,7486,262,96,21136
2569,2023-03-10,76.1,907885,319832,2114298,2702351,6044366,13087,7327,256,106,20776
2570,2023-03-13,75.0,836907,350225,1923373,2410055,5520560,10617,9010,224,132,19983
2571,2023-03-14,75.32,846503,335750,1713368,2224121,5119742,10564,8798,226,122,19710
2572,2023-03-15,75.985,905594,295484,1629806,2239916,5070800,12109,6305,249,86,18749
2573,2023-03-16,76.4,824002,179202,1049914,1694714,3747832,11613,4858,217,63,16751
2574,2023-03-17,77.06,805960,198302,1013934,1621592,3639788,12568,4998,216,72,17854
2575,2023-03-20,77.17,775801,229529,961868,1508140,3475338,12211,5410,207,92,17920
2576,2023-03-21,76.66,726287,231000,954799,1450086,3362172,10981,5668,187,97,16933
2577,2023-03-22,77.0575,740085,240351,992733,1492467,3465636,11518,6113,191,96,17918
2578,2023-03-23,76.0,756018,285236,945178,1415960,3402392,10078,7508,194,107,17887
2579,2023-03-24,77.075,771196,228538,878000,1420658,3298392,10161,5693,204,89,16147
2580,2023-03-27,76.68,763000,213018,918601,1468583,3363202,10178,5865,193,97,16333
2581,2023-03-28,76.9,797784,225156,973966,1546594,3543500,11367,5716,204,96,17383
2582,2023-03-29,77.155,821852,225450,962080,1558482,3567864,11225,6097,212,94,17628
2583,2023-03-30,77.08,790537,228602,1011936,1573871,3604946,10936,6038,213,99,17286
