,date_kotirovki,close,PhysicalLong,PhysicalShort,JuridicalLong,JuridicalShort,putov_summa,PhysicalLong_liza,PhysicalShort_liza,JuridicalLong_liza,JuridicalShort_liza,putov_summa_liza
0,2013-01-08,30.212,59699,134250,90624,16073,300646,377,240,33,35,685
1,2013-01-09,30.36,65744,149592,97197,13349,325882,396,250,42,36,724
2,2013-01-10,30.191,57871,156173,117625,19323,350992,413,254,42,39,748
3,2013-01-11,30.3145,64619,164164,117563,18018,364364,425,265,42,39,771
4,2013-01-14,30.254,77557,192439,130041,15159,415196,447,272,44,41,804
5,2013-01-15,30.3475,76941,203436,142668,16173,439218,484,286,48,43,861
6,2013-01-16,30.311,87831,263222,192930,17539,561522,489,292,51,44,876
7,2013-01-17,30.1945,89263,263415,192649,18497,563824,498,295,51,45,889
8,2013-01-18,30.27,80228,261487,197523,16264,555502,509,299,52,43,903
9,2013-01-21,30.268,80200,261988,197590,15802,555580,508,295,52,44,899
10,2013-01-22,30.225,80469,262155,197427,15741,555792,518,300,53,44,915
11,2013-01-23,30.162,85195,264584,196111,16722,562612,532,304,49,46,931
12,2013-01-24,30.0735,87594,267703,206173,26064,587534,551,312,54,46,963
13,2013-01-25,30.0325,89723,267856,206936,28803,593318,586,323,56,49,1014
14,2013-01-28,30.1675,89103,285983,214580,17700,607366,613,333,58,47,1051
15,2013-01-29,30.035,88467,289955,219236,17748,615406,618,340,56,48,1062
16,2013-01-30,30.0175,91591,292438,218629,17782,620440,627,355,53,47,1082
17,2013-01-31,30.026,91271,291711,218260,17820,619062,635,359,53,47,1094
18,2013-02-01,29.86,94720,290278,219022,23464,627484,647,378,54,56,1135
19,2013-02-04,30.0875,100180,297505,221044,23719,642448,661,384,56,56,1157
20,2013-02-05,29.95,102109,297302,223099,27906,650416,674,387,58,58,1177
21,2013-02-06,30.088,102210,303364,234052,32898,672524,686,393,57,57,1193
22,2013-02-07,30.188,101488,303699,234913,32702,672802,695,400,58,55,1208
23,2013-02-08,30.1745,101728,304070,242072,39730,687600,697,404,58,56,1215
24,2013-02-11,30.165,102102,305788,242098,38412,688400,707,405,59,57,1228
25,2013-02-12,30.04,98969,300477,241251,39743,680440,712,413,60,57,1242
26,2013-02-13,30.056,99086,300673,241392,39805,680956,721,412,59,59,1251
27,2013-02-14,30.1,104388,314609,249317,39096,707410,720,410,62,58,1250
28,2013-02-15,30.134,104847,314006,249980,40821,709654,730,408,63,58,1259
29,2013-02-18,30.134,105350,315075,251502,41777,713704,745,412,66,60,1283
30,2013-02-19,30.076,104209,313455,252540,43294,713498,755,418,66,60,1299
31,2013-02-20,30.1935,104647,313951,247939,38635,705172,770,425,69,61,1325
32,2013-02-21,30.4865,106152,318659,250605,38098,713514,768,442,69,61,1340
33,2013-02-22,30.4225,107561,322111,252549,37999,720220,776,450,67,65,1358
34,2013-02-25,30.507,110408,322825,250887,38470,722590,776,452,69,66,1363
35,2013-02-26,30.6345,107721,313730,243957,37948,703356,741,463,69,68,1341
36,2013-02-27,30.5325,107001,314446,243884,36439,701770,734,468,71,71,1344
37,2013-02-28,30.561,106904,314452,244197,36649,702202,734,473,72,73,1352
38,2013-03-01,30.699,106160,314953,245529,36736,703378,714,473,77,72,1336
39,2013-03-04,30.734,105255,311211,245597,39641,701704,703,478,77,75,1333
40,2013-03-05,30.616,108757,321093,258148,45812,733810,702,486,76,75,1339
41,2013-03-06,30.721,109731,322679,258248,45300,735958,700,486,75,75,1336
42,2013-03-07,30.6975,110773,323086,259416,47103,740378,702,490,76,74,1342
43,2013-03-11,30.7175,109417,316096,256957,50278,732748,693,486,74,76,1329
44,2013-03-12,30.701,111198,316751,256700,51147,735796,685,498,72,78,1333
45,2013-03-13,30.794,118800,322815,257214,53199,752028,679,495,74,77,1325
46,2013-03-14,30.72,111732,317943,257401,51190,738266,657,503,75,79,1314
47,2013-03-15,30.657,7008,5307,8735,10436,31486,111,108,25,25,269
48,2013-03-18,30.835,11326,6455,11105,15976,44862,155,134,30,30,349
49,2013-03-19,30.9855,12546,7607,13650,18589,52392,189,163,32,31,415
50,2013-03-20,30.85,16958,8847,15444,23555,64804,204,180,33,31,448
51,2013-03-21,30.9345,19405,10938,16624,25091,72058,222,191,34,33,480
52,2013-03-22,30.837,21171,12598,16688,25261,75718,228,205,36,34,503
53,2013-03-25,30.924,20066,16237,23771,27600,87674,252,229,42,40,563
54,2013-03-26,30.852,19573,16500,25409,28482,89964,255,239,43,40,577
55,2013-03-27,31.04,20145,16736,25395,28804,91080,263,248,43,42,596
56,2013-03-28,31.0965,22472,19071,25524,28925,95992,265,258,44,42,609
57,2013-03-29,31.06,23580,20495,25816,28901,98792,265,261,45,43,614
58,2013-04-01,31.0845,24432,21418,25860,28874,100584,274,265,46,44,629
59,2013-04-02,31.3205,25780,22462,26513,29831,104586,280,280,46,47,653
60,2013-04-03,31.644,26232,29027,34916,32121,122296,289,313,50,51,703
61,2013-04-04,31.585,29706,31117,35376,33965,130164,300,330,57,57,744
62,2013-04-05,31.52,29858,31985,37123,34996,133962,297,346,57,59,759
63,2013-04-08,31.2195,33899,35372,38403,36930,144604,333,359,61,65,818
64,2013-04-09,31.0205,38526,36133,38409,40802,153870,346,367,62,70,845
65,2013-04-10,30.884,39925,39044,40903,41784,161656,365,374,65,71,875
66,2013-04-11,30.884,40942,40709,42367,42600,166618,388,377,67,73,905
67,2013-04-12,31.085,42066,42067,42396,42395,168924,406,382,69,73,930
68,2013-04-15,31.45,39017,43680,46286,41623,170606,399,399,68,71,937
69,2013-04-16,31.263,48499,51883,45349,41965,187696,406,412,67,69,954
70,2013-04-17,31.886,50950,53294,44493,42149,190886,428,429,64,71,992
71,2013-04-18,31.55,50463,55299,48335,43499,197596,426,445,66,73,1010
72,2013-04-19,31.6635,50373,58979,51729,43123,204204,427,460,69,75,1031
73,2013-04-22,31.553,52818,58846,52549,46521,210734,429,461,70,74,1034
74,2013-04-23,31.6235,54462,59848,52174,46788,213272,436,463,68,73,1040
75,2013-04-24,31.46,56727,62064,52172,46835,217798,442,463,70,72,1047
76,2013-04-25,31.173,58051,64740,56424,49735,228950,457,464,70,74,1065
77,2013-04-26,31.254,59072,66106,58057,51023,234258,468,470,71,76,1085
78,2013-04-29,30.927,62419,68466,57989,51942,240816,480,470,72,78,1100
79,2013-04-30,31.121,64787,70415,57450,51822,244474,492,474,70,80,1116
80,2013-05-02,31.173,65364,70725,57189,51828,245106,497,479,67,82,1125
81,2013-05-03,31.053,66121,71522,57219,51818,246680,498,483,68,81,1130
82,2013-05-06,31.04,67332,73382,57471,51421,249606,492,483,69,81,1125
83,2013-05-07,31.0565,67391,73724,57433,51100,249648,494,491,69,81,1135
84,2013-05-08,31.118,67509,73836,57411,51084,249840,499,489,69,82,1139
85,2013-05-10,31.36,68632,74294,57395,51733,252054,494,499,69,83,1145
86,2013-05-13,31.3475,68590,73916,56974,51648,251128,496,509,69,82,1156
87,2013-05-14,31.356,68521,73815,56964,51670,250970,497,507,69,81,1154
88,2013-05-15,31.45,71179,74967,57344,53556,257046,500,509,69,80,1158
89,2013-05-16,31.3615,73196,75865,55506,52837,257404,497,512,73,80,1162
90,2013-05-17,31.421,73748,76922,55688,52514,258872,507,514,75,80,1176
91,2013-05-20,31.252,75309,77952,55584,52941,261786,515,523,74,81,1193
92,2013-05-21,31.238,75096,79434,52951,48613,256094,515,527,74,80,1196
93,2013-05-22,31.425,75952,80182,53049,48819,258002,520,540,75,82,1217
94,2013-05-23,31.407,76756,82693,54666,48729,262844,522,549,75,83,1229
95,2013-05-24,31.32,76308,82317,55179,49170,262974,526,550,75,83,1234
96,2013-05-27,31.362,76278,83129,55407,48556,263370,532,556,77,84,1249
97,2013-05-28,31.515,75852,81688,55348,49512,262400,538,567,77,84,1266
98,2013-05-29,31.5925,73875,79850,57244,51269,262238,535,568,80,86,1269
99,2013-05-30,31.727,74302,80604,57928,51626,264460,532,577,81,82,1272
100,2013-05-31,31.952,72684,81433,61837,53088,269042,527,578,82,86,1273
101,2013-06-03,31.779,69717,81674,64394,52437,268222,504,578,81,87,1250
102,2013-06-04,31.905,72381,88337,65046,49090,274854,509,586,85,92,1272
103,2013-06-05,32.165,74027,85434,66158,54751,280370,514,589,83,94,1280
104,2013-06-06,32.12,74105,88982,70809,55932,289828,507,593,88,93,1281
105,2013-06-07,32.1675,70809,89538,70966,52237,283550,509,601,85,96,1291
106,2013-06-10,32.307,69614,90327,71974,51261,283176,506,611,89,94,1300
107,2013-06-11,32.394,69078,93132,78683,54629,295522,493,615,92,91,1291
108,2013-06-13,31.948,71133,86153,69273,54253,280812,504,593,91,93,1281
109,2013-06-14,31.729,75483,84309,65905,57079,282776,520,581,89,96,1286
110,2013-06-17,31.7375,12056,5930,9907,16033,43926,124,96,29,30,279
111,2013-06-18,32.005,15222,10160,11401,16463,53246,175,145,31,34,385
112,2013-06-19,32.469,20746,16776,22527,26497,86546,203,186,36,35,460
113,2013-06-20,33.046,19626,23742,27616,23500,94484,217,237,44,40,538
114,2013-06-21,32.783,22874,29880,30342,23336,106432,232,275,49,45,601
115,2013-06-24,32.71,21351,29932,35467,26886,113636,244,295,54,50,643
116,2013-06-25,32.81,23658,34321,38298,27635,123912,261,318,64,52,695
117,2013-06-26,32.955,21545,37109,40552,24988,124194,274,329,63,56,722
118,2013-06-27,32.7995,22392,38102,41109,25399,127002,276,331,66,57,730
119,2013-06-28,32.803,23718,39490,41244,25472,129924,283,348,66,57,754
120,2013-07-01,32.972,24826,42197,43850,26479,137352,289,357,66,57,769
121,2013-07-02,33.1505,24789,42329,43937,26397,137452,298,375,67,56,796
122,2013-07-03,33.1295,25897,43202,45389,28084,142572,299,388,70,62,819
123,2013-07-04,33.192,26390,43674,45391,28107,143562,300,402,71,64,837
124,2013-07-05,33.3245,25547,43376,45938,28109,142970,301,406,71,65,843
125,2013-07-08,33.2235,26432,43791,46450,29091,145764,301,415,72,70,858
126,2013-07-09,32.9935,31624,49452,47481,29653,158210,304,430,76,73,883
127,2013-07-10,32.898,32053,50225,47821,29649,159748,303,432,79,74,888
128,2013-07-11,32.514,35083,52380,47806,30509,165778,320,435,79,77,911
129,2013-07-12,32.64,37249,53412,48650,32487,171798,321,439,79,81,920
130,2013-07-15,32.575,37623,55387,49361,31597,173968,327,447,81,80,935
131,2013-07-16,32.4,39924,56573,50461,33812,180770,347,439,84,79,949
132,2013-07-17,32.3395,41498,60381,53238,34355,189472,366,448,85,83,982
133,2013-07-18,32.49,42783,61924,54245,35104,194056,393,452,87,82,1014
134,2013-07-19,32.3115,43588,63301,55134,35421,197444,407,466,89,85,1047
135,2013-07-22,32.338,44922,65300,55425,35047,200694,425,481,91,85,1082
136,2013-07-23,32.3045,46576,67891,55442,34127,204036,431,486,94,85,1096
137,2013-07-24,32.4605,51232,70254,62504,43482,227472,480,499,104,87,1170
138,2013-07-25,32.6185,51896,70451,62114,43559,228020,492,499,104,88,1183
139,2013-07-26,32.7895,52262,70845,62240,43657,229004,493,502,102,87,1184
140,2013-07-29,32.8295,52762,71078,62906,44590,231336,483,503,98,87,1171
141,2013-07-30,32.9635,53151,71506,62719,44364,231740,485,517,98,83,1183
142,2013-07-31,32.9795,53893,72305,64305,45893,236396,490,523,100,84,1197
143,2013-08-01,33.074,59261,72596,64325,50990,247172,489,529,100,88,1206
144,2013-08-02,32.8475,59502,73039,65650,52113,250304,484,539,103,88,1214
145,2013-08-05,32.9055,63955,74875,65577,54657,259064,499,541,103,89,1232
146,2013-08-06,32.963,65006,76876,65779,53909,261570,499,546,103,90,1238
147,2013-08-07,32.9745,67922,79323,67443,56042,270730,504,551,105,90,1250
148,2013-08-08,32.8375,71911,80879,68183,59215,280188,511,553,105,92,1261
149,2013-08-09,32.8855,71808,80840,68647,59615,280910,516,546,106,95,1263
150,2013-08-12,32.997,71899,82460,69501,58940,282800,517,554,107,94,1272
151,2013-08-13,33.1,71785,82734,69593,58644,282756,525,557,110,93,1285
152,2013-08-14,33.0825,72734,84022,73452,62164,292372,536,555,107,93,1291
153,2013-08-15,32.88,73510,84703,73652,62459,294324,539,555,109,93,1296
154,2013-08-16,32.901,77238,85869,71510,62879,297496,547,556,109,94,1306
155,2013-08-19,32.98,77267,86453,71766,62580,298066,559,551,108,98,1316
156,2013-08-20,32.956,77390,86406,72696,63680,300172,553,555,110,100,1318
157,2013-08-21,33.123,77478,86249,72650,63879,300256,561,559,110,99,1329
158,2013-08-22,33.057,77038,85227,72950,64761,299976,564,565,108,100,1337
159,2013-08-23,33.015,78451,87117,74001,65335,304904,572,575,108,101,1356
160,2013-08-26,33.0695,78792,87390,73840,65242,305264,576,582,107,100,1365
161,2013-08-27,33.1775,78212,86990,73561,64783,303546,575,585,109,100,1369
162,2013-08-28,33.21,77129,86613,75036,65552,304330,578,594,115,100,1387
163,2013-08-29,33.25,76852,86136,75476,66192,304656,583,594,116,100,1393
164,2013-08-30,33.3145,77863,85131,79947,72679,315620,585,595,115,102,1397
165,2013-09-02,33.345,77679,83921,80098,73856,315554,585,600,118,106,1409
166,2013-09-03,33.519,75291,84242,82188,73237,314958,584,604,123,115,1426
167,2013-09-04,33.3475,76408,83540,80955,73823,314726,583,609,122,116,1430
168,2013-09-05,33.424,75213,78924,83223,79512,316872,577,602,121,117,1417
169,2013-09-06,33.27,73904,77262,83444,80086,314696,566,609,124,120,1419
170,2013-09-09,33.168,72433,75242,82058,79249,308982,556,596,124,120,1396
171,2013-09-10,32.97,74313,75341,80847,79819,310320,564,595,120,123,1402
172,2013-09-11,32.754,74001,76762,80446,77685,308894,570,586,119,126,1401
173,2013-09-12,32.6345,76701,77816,77736,76621,308874,572,596,119,127,1414
174,2013-09-13,32.48,80674,83652,78466,75488,318280,595,617,122,126,1460
175,2013-09-16,32.2775,29247,20479,4393,13161,67280,182,154,40,49,425
176,2013-09-17,32.225,42657,34442,8343,16558,102000,241,207,55,53,556
177,2013-09-18,31.8215,46513,38050,8415,16878,109856,290,244,55,59,648
178,2013-09-19,31.6365,58413,49512,10144,19045,137114,385,297,62,66,810
179,2013-09-20,31.853,67281,52835,12363,26809,159288,413,318,71,75,877
180,2013-09-23,31.8035,75413,60537,14131,29007,179088,450,334,73,80,937
181,2013-09-24,31.885,95002,64782,15279,45499,220562,467,352,74,82,975
182,2013-09-25,32.101,96557,65632,15850,46775,224814,473,371,76,82,1002
183,2013-09-26,32.325,101588,68209,18213,51592,239602,490,393,79,84,1046
184,2013-09-27,32.355,107521,66046,23812,65287,262666,483,413,88,87,1071
185,2013-09-30,32.41,109247,64667,26173,70753,270840,496,416,90,93,1095
186,2013-10-01,32.227,109372,64904,26215,70683,271174,497,421,92,95,1105
187,2013-10-02,32.234,119261,65337,27347,81271,293216,506,428,96,97,1127
188,2013-10-03,32.1445,122640,65473,33196,90363,311672,515,441,99,101,1156
189,2013-10-04,32.1815,129469,65703,38333,102099,335604,529,444,100,101,1174
190,2013-10-07,32.265,143918,64170,39592,119340,367020,540,447,101,103,1191
191,2013-10-08,32.405,143654,63991,41582,121245,370472,545,456,106,99,1206
192,2013-10-09,32.325,150449,66620,42497,126326,385892,557,466,108,103,1234
193,2013-10-10,32.1975,151575,67185,42603,126993,388356,573,468,108,105,1254
194,2013-10-11,32.2855,152430,68736,44101,127795,393062,584,481,112,103,1280
195,2013-10-14,32.28,157615,69260,44105,132460,403440,591,496,114,103,1304
196,2013-10-15,32.29,148935,53123,36621,132433,371112,417,313,78,84,892
197,2013-10-16,32.113,210414,113085,37767,135096,496362,445,353,85,80,963
198,2013-10-17,31.884,219616,116087,37445,140974,514122,477,376,85,84,1022
199,2013-10-18,31.931,226271,118459,37016,144828,526574,528,406,87,86,1107
200,2013-10-21,31.9475,226930,118755,37052,145227,527964,540,415,87,88,1130
201,2013-10-22,31.6875,229117,120701,36942,145358,532118,558,443,88,89,1178
202,2013-10-23,31.77,232869,122150,36123,146842,537984,582,466,89,91,1228
203,2013-10-24,31.7275,237176,124396,35895,148675,546142,606,478,94,92,1270
204,2013-10-25,31.762,243276,126693,40478,157061,567508,640,479,100,92,1311
205,2013-10-28,31.911,246559,129614,45390,162335,583898,664,503,101,92,1360
206,2013-10-29,32.088,244344,129076,46203,161471,581094,653,506,99,93,1351
207,2013-10-30,32.0185,246060,130440,48497,164117,589114,655,514,102,94,1365
208,2013-10-31,32.096,252283,131693,49060,169650,602686,660,524,97,98,1379
209,2013-11-01,32.42,249439,134288,52793,167944,604464,650,541,96,97,1384
210,2013-11-05,32.553,249737,134849,51187,166075,601848,648,563,96,96,1403
211,2013-11-06,32.384,250780,136805,48909,162884,599378,662,563,98,97,1420
212,2013-11-07,32.429,250443,136445,49447,163445,599780,665,569,98,98,1430
213,2013-11-08,32.6365,250440,137227,50431,163644,601742,681,574,94,98,1447
214,2013-11-11,32.796,250707,138419,50701,162989,602816,679,586,92,99,1456
215,2013-11-12,32.8905,250429,141603,56807,165633,614472,657,605,99,99,1460
216,2013-11-13,32.736,250486,142249,57499,165736,615970,659,614,98,100,1471
217,2013-11-14,32.66,250817,142029,57434,166222,616502,664,619,99,100,1482
218,2013-11-15,32.589,239022,132501,55271,161792,588586,541,459,88,90,1178
219,2013-11-18,32.575,240294,133530,57414,164178,595416,562,470,88,87,1207
220,2013-11-19,32.746,241061,134742,57980,164299,598082,572,485,91,88,1236
221,2013-11-20,32.9335,242460,134270,57226,165416,599372,575,486,90,90,1241
222,2013-11-21,32.992,243733,137015,58783,165501,605032,580,504,90,86,1260
223,2013-11-22,32.7555,243799,137912,59442,165329,606482,592,500,95,85,1272
224,2013-11-25,32.934,244136,137941,59601,165796,607474,598,506,99,89,1292
225,2013-11-26,32.9405,244128,138617,59847,165358,607950,594,512,99,89,1294
226,2013-11-27,33.18,244649,138901,60105,165853,609508,593,514,100,89,1296
227,2013-11-28,33.148,246604,140682,60529,166451,614266,602,523,102,89,1316
228,2013-11-29,33.1555,252994,150719,60736,163011,627460,616,533,101,91,1341
229,2013-12-02,33.2395,254945,152092,61336,164189,632562,620,547,100,94,1361
230,2013-12-03,33.2685,254658,152294,61411,163775,632138,614,553,99,93,1359
231,2013-12-04,33.1815,256516,152352,60479,164643,633990,604,560,100,93,1357
232,2013-12-05,32.9855,256051,154290,63463,165224,639028,607,575,105,95,1382
233,2013-12-06,32.7,256894,155962,65735,166667,645258,616,586,109,96,1407
234,2013-12-09,32.7525,258349,156419,65627,167557,647952,632,610,110,94,1446
235,2013-12-10,32.7005,263482,157111,60692,167063,648348,641,594,111,94,1440
236,2013-12-11,32.778,266648,156691,60970,170927,655236,651,583,107,93,1434
237,2013-12-12,32.7915,262511,155698,60439,167252,645900,646,580,107,93,1426
238,2013-12-13,32.8505,260322,156342,59114,163094,638872,641,583,105,95,1424
239,2013-12-16,32.9025,16354,12137,7146,11363,47000,139,124,18,26,307
240,2013-12-17,32.9695,24211,61723,115394,77882,279210,178,175,25,30,408
241,2013-12-18,32.814,26249,62254,125698,89693,303894,209,198,29,35,471
242,2013-12-19,32.99,28571,64968,126509,90112,310160,235,226,33,35,529
243,2013-12-20,32.98,31028,70870,130100,90258,322256,247,238,35,35,555
244,2013-12-23,32.661,31412,72444,130388,89356,323600,267,261,38,34,600
245,2013-12-24,32.64,35337,74248,130390,91479,331454,292,289,40,34,655
246,2013-12-25,32.6905,36914,75839,130516,91591,334860,302,296,41,36,675
247,2013-12-26,32.6665,37361,76191,130519,91689,335760,312,301,42,36,691
248,2013-12-27,32.5945,39795,78542,130623,91876,340836,340,315,42,34,731
249,2013-12-30,32.835,41658,80626,134758,95790,352832,349,324,47,36,756
250,2014-01-06,33.2125,45943,90432,141434,96945,374754,358,344,53,38,793
251,2014-01-08,33.1935,46670,92499,142764,96935,378868,371,364,52,41,828
252,2014-01-09,33.234,48554,95004,193387,146937,483882,379,380,55,44,858
253,2014-01-10,33.027,54854,89850,200746,165750,511200,383,392,54,47,876
254,2014-01-13,33.2825,54202,89873,201532,165861,511468,384,406,53,48,891
255,2014-01-14,33.302,54083,89440,201360,166003,510886,380,416,52,51,899
256,2014-01-15,33.4,43857,68515,190614,165956,468942,272,281,47,50,650
257,2014-01-16,33.4125,42543,76096,200428,166875,485942,304,323,62,55,744
258,2014-01-17,33.5905,44085,83129,206291,167247,500752,314,350,64,58,786
259,2014-01-20,33.768,46681,85890,206945,167736,507252,332,398,67,67,864
260,2014-01-21,33.935,52119,84750,180399,147768,465036,360,459,71,76,966
261,2014-01-22,33.9305,53154,84373,180171,148952,466650,371,469,69,86,995
262,2014-01-23,34.115,55500,88610,181969,148859,474938,392,534,72,88,1086
263,2014-01-24,34.527,66313,100778,139567,105102,411760,457,617,84,94,1252
264,2014-01-27,34.69,67189,110513,135003,91679,404384,484,650,103,109,1346
265,2014-01-28,34.742,71589,112988,135829,94430,414836,487,690,108,114,1399
266,2014-01-29,35.1305,77649,98971,145531,124209,446360,509,741,114,118,1482
267,2014-01-30,34.905,86021,98642,148352,135731,468746,588,792,116,134,1630
268,2014-01-31,35.196,85929,101072,150760,135617,473378,584,837,125,140,1686
269,2014-02-03,35.44,86958,100638,150339,136659,474594,610,860,125,143,1738
270,2014-02-04,35.003,90166,103922,150252,136496,480836,640,888,130,148,1806
271,2014-02-05,34.898,87822,105709,151156,133269,477956,657,893,133,149,1832
272,2014-02-06,34.694,87852,109844,150569,128577,476842,674,910,132,149,1865
273,2014-02-07,34.7685,89229,115480,152163,125912,482784,706,928,134,156,1924
274,2014-02-10,34.76,89507,116173,151446,124780,481906,712,936,137,156,1941
275,2014-02-11,34.7525,90017,119997,152605,122625,485244,722,950,137,158,1967
276,2014-02-12,34.831,91444,120338,153356,124462,489600,730,948,140,151,1969
277,2014-02-13,35.1495,97152,122841,153875,128186,502054,754,970,135,151,2010
278,2014-02-14,35.08,97876,122827,155146,130195,506044,772,971,138,151,2032
279,2014-02-17,35.2195,79064,105159,148830,122735,455788,546,668,107,116,1437
280,2014-02-18,35.4115,80265,112979,151690,118976,463910,572,716,109,118,1515
281,2014-02-19,35.795,81096,118339,156484,119241,475160,598,788,115,133,1634
282,2014-02-20,35.775,82560,117958,156819,121421,478758,623,801,122,144,1690
283,2014-02-21,35.489,86402,120133,157629,123898,488062,639,812,124,151,1726
284,2014-02-24,35.483,87329,122944,159762,124147,494182,668,826,127,149,1770
285,2014-02-25,35.705,91043,126959,166580,130664,515246,661,840,131,134,1766
286,2014-02-26,36.0195,92594,126779,167890,133705,520968,679,860,129,149,1817
287,2014-02-27,36.036,91411,127444,169919,133886,522660,685,877,133,158,1853
288,2014-02-28,35.886,94880,131199,172857,136538,535474,691,880,145,161,1877
289,2014-03-03,36.51,93852,121564,161873,134161,511450,698,828,137,167,1830
290,2014-03-04,36.065,96250,115533,159470,140187,511440,719,829,142,161,1851
291,2014-03-05,36.0435,98761,112903,158673,144531,514868,735,832,146,164,1877
292,2014-03-06,36.1365,99525,105783,158242,151984,515534,733,828,149,166,1876
293,2014-03-07,36.4695,99655,102164,158542,156033,516394,745,831,148,173,1897
294,2014-03-11,36.5,98957,100789,158352,156520,514618,738,820,146,172,1876
295,2014-03-12,36.5,96760,100094,161670,158336,516860,743,826,142,176,1887
296,2014-03-13,36.6085,95487,101412,160152,154227,511278,747,839,138,173,1897
297,2014-03-14,36.597,90506,105124,158829,144211,498670,751,844,139,173,1907
298,2014-03-17,36.33,19976,23603,18900,15273,77752,250,243,59,55,607
299,2014-03-18,36.2205,22342,25412,23066,19996,90816,278,284,75,58,695
300,2014-03-19,36.136,28036,31214,23907,20729,103886,316,322,76,64,778
301,2014-03-20,36.38,29777,32703,24444,21518,108442,337,339,74,66,816
302,2014-03-21,36.2595,30151,33485,24908,21574,110118,350,363,74,67,854
303,2014-03-24,36.052,33200,38357,27233,22076,120866,366,377,80,68,891
304,2014-03-25,35.56,37182,43468,29527,23241,133418,397,413,85,71,966
305,2014-03-26,35.53,39058,48420,34292,24930,146700,432,429,100,78,1039
306,2014-03-27,35.5905,41951,51057,35005,25899,153912,448,454,97,82,1081
307,2014-03-28,35.78,42646,52216,35185,25615,155662,451,468,98,82,1099
308,2014-03-31,35.12,44427,56570,35946,23803,160746,501,478,96,84,1159
309,2014-04-01,35.0995,48053,61262,36774,23565,169654,540,501,101,90,1232
310,2014-04-02,35.418,48386,62951,37820,23255,172412,552,535,105,97,1289
311,2014-04-03,35.5,48526,63898,40289,24917,177630,557,547,120,105,1329
312,2014-04-04,35.3,49169,64753,41560,25976,181458,566,553,122,106,1347
313,2014-04-07,35.642,50728,66828,43251,27151,187958,568,573,124,112,1377
314,2014-04-08,35.6805,52616,67936,43871,28551,192974,578,583,126,113,1400
315,2014-04-09,35.642,53754,67757,43283,29280,194074,585,579,125,115,1404
316,2014-04-10,35.57,53232,67497,43392,29127,193248,590,587,124,114,1415
317,2014-04-11,35.645,53481,67294,44156,30343,195274,598,591,125,114,1428
318,2014-04-14,35.9845,54909,69225,45266,30950,200350,600,599,126,110,1435
319,2014-04-15,36.1925,32685,45322,36673,24036,138716,344,331,93,82,850
320,2014-04-16,35.9885,35639,52708,42326,25257,155930,383,376,99,87,945
321,2014-04-17,35.46,36549,54415,45092,27226,163282,404,402,100,89,995
322,2014-04-18,35.6105,39573,58194,46266,27645,171678,425,444,103,92,1064
323,2014-04-21,35.7265,41371,59771,46480,28080,175702,435,457,103,92,1087
324,2014-04-22,35.699,43850,61833,48134,30151,183968,444,468,104,96,1112
325,2014-04-23,35.6755,44077,63337,49411,30151,186976,456,473,106,98,1133
326,2014-04-24,35.772,46865,67295,52557,32127,198844,470,488,102,100,1160
327,2014-04-25,36.0285,45178,68227,56337,33288,203030,463,502,103,104,1172
328,2014-04-28,35.821,45937,69273,59739,36403,211352,471,508,102,105,1186
329,2014-04-29,35.602,45576,71296,62065,36345,215282,481,528,113,99,1221
330,2014-04-30,35.63,46075,72011,63068,37132,218286,484,541,116,98,1239
331,2014-05-02,35.8735,47074,72355,63665,38384,221478,489,553,118,99,1259
332,2014-05-05,35.7195,47331,72704,63831,38458,222324,491,556,118,102,1267
333,2014-05-06,35.41,47643,75158,65025,37510,225336,497,553,119,102,1271
334,2014-05-07,34.9295,49335,78621,69123,39837,236916,527,564,129,102,1322
335,2014-05-08,35.04,51307,80181,70422,41548,243458,554,581,131,103,1369
336,2014-05-12,35.0425,51689,81464,70850,41075,245078,569,588,133,104,1394
337,2014-05-13,34.8525,51999,82942,72729,41786,249456,597,606,143,104,1450
338,2014-05-14,34.72,54540,83335,74132,45337,257344,630,627,145,108,1510
339,2014-05-15,34.75,39158,60110,62053,41101,202422,458,411,119,86,1074
340,2014-05-16,34.77,39962,62220,63835,41577,207594,487,452,121,89,1149
341,2014-05-19,34.5655,47503,66261,64148,45390,223302,531,474,122,97,1224
342,2014-05-20,34.5215,48894,68647,65787,46034,229362,558,505,125,97,1285
343,2014-05-21,34.345,49987,69202,67441,48226,234856,580,509,127,103,1319
344,2014-05-22,34.3195,58142,72226,67695,53611,251674,636,505,125,111,1377
345,2014-05-23,34.17,61266,72957,70391,58700,263314,671,517,129,121,1438
346,2014-05-26,34.2035,62571,72291,70156,60436,265454,699,530,130,127,1486
347,2014-05-27,34.406,63901,71955,70612,62558,269026,702,545,135,136,1518
348,2014-05-28,34.5615,64050,71998,70806,62858,269712,704,553,132,138,1527
349,2014-05-29,34.658,62449,73860,75121,63710,275140,694,568,130,141,1533
350,2014-05-30,34.8945,62606,75407,81813,69012,288838,686,580,130,142,1538
351,2014-06-02,34.93,61639,75417,84177,70399,291632,678,591,132,145,1546
352,2014-06-03,35.0695,61218,75430,85752,71540,293940,669,610,132,147,1558
353,2014-06-04,34.9995,60621,78908,94242,75955,309726,656,624,137,148,1565
354,2014-06-05,34.7415,62350,81465,97039,77924,318778,674,633,141,151,1599
355,2014-06-06,34.418,66923,84125,96711,79509,327268,694,635,142,150,1621
356,2014-06-09,34.34,69215,82457,92288,79046,323006,715,631,142,145,1633
357,2014-06-10,34.365,72468,82483,89621,79606,324178,727,631,145,143,1646
358,2014-06-11,34.379,74120,83721,93931,84330,336102,747,636,148,145,1676
359,2014-06-13,34.452,76047,82254,89962,83755,332018,773,638,151,143,1705
360,2014-06-16,34.6385,9858,16761,24026,17123,67768,181,162,64,51,458
361,2014-06-17,34.8265,14337,21529,25293,18101,79260,227,199,82,53,561
362,2014-06-18,34.42,16333,26188,28719,18864,90104,252,217,86,59,614
363,2014-06-19,34.396,18281,28826,30080,19535,96722,312,252,95,62,721
364,2014-06-20,34.479,19902,30522,30555,19935,100914,322,268,96,67,753
365,2014-06-23,34.127,21436,34006,33073,20503,109018,358,292,98,75,823
366,2014-06-24,33.8175,26062,38888,35506,22680,123136,417,326,108,88,939
367,2014-06-25,33.7455,28764,44103,43506,28167,144540,474,346,118,92,1030
368,2014-06-26,33.72,30960,46071,44828,29717,151576,504,359,122,95,1080
369,2014-06-27,33.738,33416,46719,46800,33497,160432,540,381,140,115,1176
370,2014-06-30,33.9825,36548,49662,53711,40597,180518,566,397,138,127,1228
371,2014-07-01,34.34,35087,49244,55550,41393,181274,551,414,139,129,1233
372,2014-07-02,34.281,34843,49753,57797,42887,185280,544,434,145,132,1255
373,2014-07-03,34.284,35274,49540,64304,50038,199156,552,438,145,134,1269
374,2014-07-04,34.42,35563,49297,64519,50785,200164,540,440,148,135,1263
375,2014-07-07,34.455,36044,48952,64747,51839,201582,534,441,151,138,1264
376,2014-07-08,34.23,36942,49387,65834,53389,205552,540,444,148,143,1275
377,2014-07-09,33.9125,38512,51913,67124,53723,211272,557,450,152,143,1302
378,2014-07-10,33.95,41192,53865,67763,55090,217910,584,458,153,142,1337
379,2014-07-11,34.2055,42444,56406,69510,55548,223908,579,461,153,144,1337
380,2014-07-14,34.3275,41345,57142,72407,56610,227504,560,476,156,144,1336
381,2014-07-15,34.3945,19264,34316,62991,47939,164510,289,237,107,107,740
382,2014-07-16,34.3875,20852,36603,64356,48605,170416,324,278,114,112,828
383,2014-07-17,35.182,25713,41106,68426,53033,188278,329,322,130,131,912
384,2014-07-18,35.1425,26200,42429,71340,55111,195080,345,357,140,136,978
385,2014-07-21,35.19,27079,46151,74450,55378,203058,369,400,147,138,1054
386,2014-07-22,34.996,27651,47955,79597,59293,214496,375,418,147,149,1089
387,2014-07-23,34.8995,29538,47955,80391,61974,219858,396,427,151,150,1124
388,2014-07-24,35.0435,32243,51243,83668,64668,231822,410,450,155,148,1163
389,2014-07-25,35.13,34426,52358,83606,65674,236064,418,461,157,151,1187
390,2014-07-28,35.5425,43522,37478,75202,81246,237448,419,452,163,178,1212
391,2014-07-29,35.8045,44410,38814,75384,80980,239588,414,483,167,180,1244
392,2014-07-30,35.586,41362,38398,79342,82306,241408,430,497,176,185,1288
393,2014-07-31,35.7485,43951,39913,79686,83724,247274,445,514,172,191,1322
394,2014-08-01,35.7495,45816,43243,83847,86420,259326,462,529,169,192,1352
395,2014-08-04,35.783,46514,43677,84071,86908,261170,467,541,166,195,1369
396,2014-08-05,36.0785,48263,44457,85498,89304,267522,480,536,170,196,1382
397,2014-08-06,36.189,49431,44656,86997,91772,272856,480,545,170,196,1391
398,2014-08-07,36.27,51637,45157,87310,93790,277894,478,553,175,193,1399
399,2014-08-08,36.1205,54649,47074,87528,95103,284354,487,573,174,200,1434
400,2014-08-11,35.929,56327,48161,88235,96401,289124,492,597,169,205,1463
401,2014-08-12,36.18,58415,48825,86114,95704,289058,503,607,172,204,1486
402,2014-08-13,36.0005,58233,48286,87353,97300,291172,507,620,176,210,1513
403,2014-08-14,36.036,58670,50218,87363,95815,292066,520,628,180,207,1535
404,2014-08-15,36.131,44622,31028,75493,89087,240230,359,323,135,157,974
405,2014-08-18,36.0595,45137,32019,79387,92505,249048,374,361,139,172,1046
406,2014-08-19,36.185,46350,32833,79905,93422,252510,398,379,141,172,1090
407,2014-08-20,36.3005,46100,33731,82081,94450,256362,418,400,144,173,1135
408,2014-08-21,36.024,46287,35384,84961,95864,262496,423,414,146,172,1155
409,2014-08-22,36.11,46113,36176,89037,98974,270300,428,427,147,180,1182
410,2014-08-25,36.095,46623,36556,89130,99197,271506,438,439,149,182,1208
411,2014-08-26,36.1005,48774,41889,93550,100435,284648,446,470,153,187,1256
412,2014-08-27,36.172,49410,42055,92070,99425,282960,456,475,158,189,1278
413,2014-08-28,36.75,51153,44003,96098,103248,294502,461,501,155,195,1312
414,2014-08-29,37.1235,51275,44832,95817,102260,294184,460,520,155,198,1333
415,2014-09-01,37.302,52699,47574,97675,102800,300748,461,562,158,213,1394
416,2014-09-02,37.4625,53449,48314,148360,153495,403618,477,584,172,221,1454
417,2014-09-03,36.863,54063,49281,150687,155469,409500,501,592,186,228,1507
418,2014-09-04,37.0075,54061,49828,152099,156332,412320,519,596,193,228,1536
419,2014-09-05,36.92,58463,49024,160752,170191,438430,535,594,200,228,1557
420,2014-09-08,37.0695,58659,48763,162026,171922,441370,546,597,204,232,1579
421,2014-09-09,37.1115,59257,50176,163854,172935,446222,548,604,203,234,1589
422,2014-09-10,37.29,62724,52067,168593,179250,462634,548,610,204,239,1601
423,2014-09-11,37.5095,60629,57992,181152,183789,483562,524,619,201,248,1592
424,2014-09-12,37.785,61013,58066,184244,187191,490514,511,623,206,248,1588
425,2014-09-15,38.385,26697,16998,97249,106948,247892,202,224,106,118,650
426,2014-09-16,38.33,39384,27562,109376,121198,297520,298,371,133,158,960
427,2014-09-17,38.419,43144,31469,109944,121619,306176,342,411,138,161,1052
428,2014-09-18,38.478,44014,36132,114785,122667,317598,368,429,141,164,1102
429,2014-09-19,38.4215,44269,36811,115612,123070,319762,379,431,138,165,1113
430,2014-09-22,38.6995,44372,37996,119905,126281,328554,397,438,141,164,1140
431,2014-09-23,38.616,45276,41686,123926,127516,338404,412,459,145,169,1185
432,2014-09-24,38.15,48023,44871,126362,129514,348770,438,463,151,171,1223
433,2014-09-25,38.4915,49307,46534,128804,131577,356222,451,479,154,170,1254
434,2014-09-26,39.1765,49959,47753,134072,136278,368062,458,509,161,179,1307
435,2014-09-29,39.4395,53290,52929,144492,144853,395564,480,540,176,204,1400
436,2014-09-30,39.5925,56271,55855,149980,150396,412502,488,557,182,202,1429
437,2014-10-01,39.7,57952,56707,153512,154757,422928,505,591,190,206,1492
438,2014-10-02,39.561,60062,55837,154316,158541,428756,517,606,189,211,1523
439,2014-10-03,39.957,60317,56472,156677,160522,433988,517,624,192,218,1551
440,2014-10-06,39.73,60302,57441,159761,162622,440126,539,654,193,218,1604
441,2014-10-07,39.904,60987,55740,158472,163719,438918,536,662,195,220,1613
442,2014-10-08,40.0,62577,53512,164360,173425,453874,537,674,198,229,1638
443,2014-10-09,40.1475,64906,56317,166344,174933,462500,534,688,198,234,1654
444,2014-10-10,40.325,65313,59316,166132,172129,462890,558,704,209,233,1704
445,2014-10-13,40.4925,66663,59870,168960,175753,471246,576,713,215,244,1748
446,2014-10-14,40.92,73393,64051,180855,190197,508496,593,734,213,255,1795
447,2014-10-15,40.4505,49318,28177,117960,139101,334556,418,376,139,163,1096
448,2014-10-16,40.869,58941,32546,123544,149939,364970,478,454,156,177,1265
449,2014-10-17,40.7525,62184,35398,126330,153116,377028,502,475,160,185,1322
450,2014-10-20,41.0375,65083,39519,129654,155218,389474,518,515,167,191,1391
451,2014-10-21,40.964,65349,43648,136092,157793,402882,520,532,166,192,1410
452,2014-10-22,41.4195,68367,44601,138173,161939,413080,536,541,172,201,1450
453,2014-10-23,41.715,68789,46066,845312,868035,1828202,545,594,190,229,1558
454,2014-10-24,41.906,76695,51497,1063849,1089047,2281088,596,641,196,270,1703
455,2014-10-27,42.28,77483,59094,1132517,1150906,2420000,600,714,198,301,1813
456,2014-10-28,42.468,79812,65580,1806755,1820987,3773134,652,802,229,317,2000
457,2014-10-29,43.2,83490,70066,2061155,2074579,4289290,736,871,249,338,2194
458,2014-10-30,41.6445,89644,83951,2374507,2380200,4928302,823,971,274,384,2452
459,2014-10-31,43.034,92459,84717,2777077,2784819,5739072,852,996,287,394,2529
460,2014-11-03,43.608,92682,88358,2781318,2785642,5748000,870,1038,291,403,2602
461,2014-11-05,44.95,92689,87684,3882515,3887520,7950408,918,1060,319,428,2725
462,2014-11-06,46.8675,102743,94053,4139999,4148689,8485484,991,1126,353,461,2931
463,2014-11-07,46.65,109157,95931,3691896,3705122,7602106,1068,1195,378,479,3120
464,2014-11-10,45.8525,113498,98229,3826174,3841443,7879344,1145,1274,428,538,3385
465,2014-11-11,46.3515,126537,105196,3836138,3857479,7925350,1169,1307,434,576,3486
466,2014-11-12,45.9615,127517,109194,3795364,3813687,7845762,1203,1330,448,590,3571
467,2014-11-13,46.82,132569,113920,3751167,3769816,7767472,1266,1373,460,597,3696
468,2014-11-14,47.1735,132859,116430,3856950,3873379,7979618,1280,1413,476,610,3779
469,2014-11-17,47.1045,92727,69907,3808804,3831624,7803062,851,717,331,360,2259
470,2014-11-18,46.9025,94445,73827,4017133,4037751,8223156,898,804,352,381,2435
471,2014-11-19,46.861,97943,75965,4018324,4040302,8232534,923,841,355,384,2503
472,2014-11-20,46.152,97277,77497,4038004,4057784,8270562,947,873,364,394,2578
473,2014-11-21,45.714,96445,79743,4041181,4057883,8275252,984,944,377,409,2714
474,2014-11-24,44.997,112338,93955,4053954,4072337,8332584,1084,1011,396,425,2916
475,2014-11-25,46.263,149252,109424,4206354,4246182,8711212,1139,1057,420,440,3056
476,2014-11-26,47.388,161294,114002,4270433,4317725,8863454,1178,1103,422,453,3156
477,2014-11-27,48.655,167810,124490,4379098,4422418,9093816,1224,1201,425,462,3312
478,2014-11-28,50.4085,168516,125956,4361825,4404385,9060682,1193,1285,448,488,3414
479,2014-12-01,51.22,170084,126210,4061470,4105344,8463108,1221,1329,468,527,3545
480,2014-12-02,53.85,168758,124375,4060148,4104531,8457812,1240,1407,479,548,3674
481,2014-12-03,53.1905,165133,122183,4047311,4090261,8424888,1314,1432,491,570,3807
482,2014-12-04,54.29,178064,129312,3797562,3846314,7951252,1351,1503,501,595,3950
483,2014-12-05,52.51,179270,129108,3747169,3797331,7852878,1409,1528,508,682,4127
484,2014-12-08,53.745,179140,129426,3702931,3752645,7764142,1413,1570,517,705,4205
485,2014-12-09,54.049,163437,126231,3656388,3693594,7639650,1431,1562,529,708,4230
486,2014-12-10,54.85,146485,126504,3672419,3692400,7637808,1448,1612,541,723,4324
487,2014-12-11,56.44,153425,136298,3680892,3698019,7668634,1469,1693,548,731,4441
488,2014-12-12,58.18,133113,128183,3688388,3693318,7643002,1508,1693,569,725,4495
489,2014-12-15,64.4455,19098,3882,3181594,3196810,6401384,313,241,146,153,853
490,2014-12-16,67.5,23150,4231,2931662,2950581,5909624,375,296,162,177,1010
491,2014-12-17,60.2205,16926,4349,1991851,2004428,4017554,423,338,172,180,1113
492,2014-12-18,61.5,17968,4916,1491798,1504850,3019532,471,383,183,193,1230
493,2014-12-19,58.55,18284,5226,1491917,1504975,3020402,501,431,189,204,1325
494,2014-12-22,55.8,21161,6724,1291922,1306359,2626166,635,503,197,219,1554
495,2014-12-23,54.5035,26991,10072,1223199,1240118,2500380,708,555,212,230,1705
496,2014-12-24,53.44,24350,10981,1222811,1236180,2494322,757,593,221,241,1812
497,2014-12-25,52.5515,24445,12666,1224032,1235811,2496954,836,646,252,266,2000
498,2014-12-26,54.004,20932,13480,1224403,1231855,2490670,872,685,259,270,2086
499,2014-12-29,58.322,21018,13840,1224784,1231962,2491604,884,705,270,270,2129
500,2014-12-29,58.322,21018,13840,1224784,1231962,2491604,884,705,270,270,2129
501,2014-12-30,56.0,21689,14682,1225478,1232485,2494334,949,735,273,278,2235
502,2015-01-05,60.85,21647,15022,1226061,1232686,2495416,987,762,278,285,2312
503,2015-01-06,63.24,22744,15049,1226078,1233773,2497644,1029,784,270,283,2366
504,2015-01-08,60.301,23732,16261,1226236,1233707,2499936,1014,808,272,288,2382
505,2015-01-09,61.55,24372,16627,1226393,1234138,2501530,1036,832,274,294,2436
506,2015-01-12,63.17,24629,17266,1226575,1233938,2502408,1029,868,292,293,2482
507,2015-01-13,65.25,25935,18401,1229074,1236608,2510018,1045,912,309,309,2575
508,2015-01-14,64.773,27579,19550,1230925,1238954,2517008,1046,938,321,325,2630
509,2015-01-15,65.29,16291,9650,1228239,1234880,2489060,589,399,207,215,1410
510,2015-01-16,65.1985,16947,10520,1228945,1235372,2491784,634,467,242,236,1579
511,2015-01-19,65.02,17417,11760,1230286,1235943,2495406,654,521,263,257,1695
512,2015-01-20,65.2,18402,13043,1233856,1239215,2504516,682,551,270,271,1774
513,2015-01-21,65.35,18952,14192,1234707,1239467,2507318,699,572,281,276,1828
514,2015-01-22,64.12,19857,14487,1212058,1217428,2463830,720,583,291,279,1873
515,2015-01-23,64.2395,19957,17631,1218870,1221196,2477654,753,622,305,290,1970
516,2015-01-26,68.799,33383,24666,1226023,1234740,2518812,801,658,320,294,2073
517,2015-01-27,66.82,39536,28048,1232612,1244100,2544296,904,689,350,317,2260
518,2015-01-28,68.0345,45131,29913,1240633,1255851,2571528,947,729,374,335,2385
519,2015-01-29,68.73,46437,31247,1241133,1256323,2575140,993,770,388,356,2507
520,2015-01-30,68.9105,46960,32673,1243440,1257727,2580800,1031,827,402,372,2632
521,2015-02-02,68.42,48530,34155,1255195,1269570,2607450,1096,839,430,411,2776
522,2015-02-03,65.168,42957,32931,1240103,1250129,2566120,1154,845,448,420,2867
523,2015-02-04,67.993,43849,35387,1195438,1203900,2478574,1168,874,451,423,2916
524,2015-02-05,66.6,54599,39383,1198335,1213551,2505868,1181,894,464,427,2966
525,2015-02-06,66.985,64158,41068,1202883,1225973,2534082,1198,898,463,435,2994
526,2015-02-09,65.86,78348,45845,1209265,1241768,2575226,1232,908,472,441,3053
527,2015-02-10,65.455,86700,48199,1210415,1248916,2594230,1246,932,478,455,3111
528,2015-02-11,65.25,93543,50795,1209895,1252643,2606876,1270,941,480,465,3156
529,2015-02-12,65.27,93148,52632,1211976,1252492,2610248,1267,983,493,469,3212
530,2015-02-13,63.5,91254,54195,1217046,1254105,2616600,1290,1016,498,493,3297
531,2015-02-16,63.184,70480,33961,1191804,1228323,2524568,840,532,361,344,2077
532,2015-02-17,62.505,76562,39042,1195759,1233279,2544642,905,602,372,358,2237
533,2015-02-18,61.582,77842,40935,1198229,1235136,2552142,967,658,386,370,2381
534,2015-02-19,61.9,85532,44922,1204237,1244847,2579538,1016,687,406,380,2489
535,2015-02-20,62.05,86364,49414,1259335,1296285,2691398,1041,729,407,387,2564
536,2015-02-24,62.853,87907,52657,1409557,1444807,2994928,1074,769,411,410,2664
537,2015-02-25,61.389,89839,56254,1486014,1519599,3151706,1105,813,427,425,2770
538,2015-02-26,61.15,93870,59121,1519970,1554719,3227680,1151,838,440,443,2872
539,2015-02-27,61.6,97232,60939,1569152,1605445,3332768,1167,866,454,451,2938
540,2015-03-02,62.65,97366,61399,1569886,1605853,3334504,1176,889,458,456,2979
541,2015-03-03,61.887,98146,59829,1573779,1612096,3343850,1207,892,462,462,3023
542,2015-03-04,61.945,99582,60466,1574042,1613158,3347248,1232,894,471,466,3063
543,2015-03-05,60.821,98842,63023,1580666,1616485,3359016,1254,927,496,469,3146
544,2015-03-06,60.445,108127,68761,1487766,1527132,3191786,1309,983,504,477,3273
545,2015-03-10,62.53,109408,71350,1390804,1428862,3000424,1312,1019,521,488,3340
546,2015-03-11,61.617,117960,78442,1387402,1426920,3010724,1341,1055,514,496,3406
547,2015-03-12,61.19,127230,81549,1386808,1432489,3028076,1401,1077,505,515,3498
548,2015-03-13,62.249,123511,78297,933024,978238,2113070,1433,1083,510,508,3534
549,2015-03-16,62.192,19288,17053,373114,375349,784804,278,269,104,115,766
550,2015-03-17,61.45,21782,18024,373270,377028,790104,371,337,122,132,962
551,2015-03-18,59.335,24979,22347,283542,286174,617042,421,409,149,148,1127
552,2015-03-19,59.994,24950,25451,185983,185482,421866,510,443,160,165,1278
553,2015-03-20,59.255,25519,24882,187782,188419,426602,558,477,186,186,1407
554,2015-03-23,58.741,26920,27748,190256,189428,434352,631,508,191,225,1555
555,2015-03-24,57.69,30624,31979,202844,201489,466936,701,593,208,263,1765
556,2015-03-25,57.45,39373,39338,208252,208287,495250,802,675,212,294,1983
557,2015-03-26,57.291,42694,39874,210056,212876,505500,882,691,219,311,2103
558,2015-03-27,57.9,43819,41203,215484,218100,518606,906,710,229,317,2162
559,2015-03-30,57.61,44173,42105,216479,218547,521304,924,724,243,310,2201
560,2015-03-31,58.205,44945,43026,217743,219662,525376,946,744,249,310,2249
561,2015-04-01,57.61,46919,43435,218218,221702,530274,968,759,254,309,2290
562,2015-04-02,56.65,49545,47410,227432,229567,553954,1015,795,265,321,2396
563,2015-04-03,56.606,56499,53445,225627,228681,564252,1050,830,275,332,2487
564,2015-04-06,55.488,65993,60926,236796,241863,605578,1151,878,284,357,2670
565,2015-04-07,55.026,70015,64144,241314,247185,622658,1259,939,302,381,2881
566,2015-04-08,53.637,76531,85007,273406,264930,699874,1400,1043,345,420,3208
567,2015-04-09,51.862,83517,87655,278390,274252,723814,1625,1113,374,447,3559
568,2015-04-10,53.6,90844,93038,290067,287873,761822,1832,1238,408,509,3987
569,2015-04-13,52.03,91813,93163,292368,291018,768362,1873,1300,422,513,4108
570,2015-04-14,50.897,99186,94999,293387,297574,785146,1988,1313,434,523,4258
571,2015-04-15,49.7,49605,37331,206942,219216,513094,1135,555,256,302,2248
572,2015-04-16,49.8,57480,42191,207429,222718,529818,1396,721,276,345,2738
573,2015-04-17,51.895,60146,44311,213384,229219,547060,1464,781,309,355,2909
574,2015-04-20,53.335,63755,49992,223024,236787,573558,1516,836,343,368,3063
575,2015-04-21,53.8,65758,54024,227940,239674,587396,1547,900,370,379,3196
576,2015-04-22,52.18,70920,58699,233796,246017,609432,1629,945,377,393,3344
577,2015-04-23,50.78,76911,64538,240403,252776,634628,1807,965,385,410,3567
578,2015-04-24,50.9,81097,70862,245087,255322,652368,1951,1017,399,413,3780
579,2015-04-27,51.978,83661,73753,249237,259145,665796,2016,1059,413,416,3904
580,2015-04-28,51.546,88239,75944,252932,265227,682342,2066,1085,414,420,3985
581,2015-04-29,51.055,88614,77453,253526,264687,684280,2110,1094,409,437,4050
582,2015-04-30,51.69,91106,77456,256087,269737,694386,2134,1104,423,439,4100
583,2015-05-05,50.496,95608,77248,254545,272905,700306,2146,1128,428,457,4159
584,2015-05-06,50.998,96749,79377,268397,285769,730292,2263,1169,430,480,4342
585,2015-05-07,50.29,99307,84067,273022,288262,744658,2333,1206,437,486,4462
586,2015-05-08,51.04,98383,87595,276963,287751,750692,2328,1229,435,494,4486
587,2015-05-12,49.958,108442,88792,283187,302837,783258,2360,1210,448,497,4515
588,2015-05-13,49.27,119217,90761,288378,316834,815190,2463,1255,462,525,4705
589,2015-05-14,50.134,134724,96219,293109,331614,855666,2552,1284,500,534,4870
590,2015-05-15,49.57,87845,65446,268286,290685,712262,1826,724,358,371,3279
591,2015-05-18,49.147,93731,69971,282654,306414,752770,1994,863,387,396,3640
592,2015-05-19,49.57,97336,75263,294929,317002,784530,2074,916,407,422,3819
593,2015-05-20,49.701,102092,75742,341365,367715,886914,2133,930,417,422,3902
594,2015-05-21,49.99,104627,75344,400298,429581,1009850,2191,961,431,430,4013
595,2015-05-22,50.028,105328,75631,412126,441823,1034908,2246,981,433,446,4106
596,2015-05-25,49.965,109640,77598,416866,448908,1053012,2298,988,439,452,4177
597,2015-05-26,50.96,109076,79075,419050,449051,1056252,2335,1025,450,451,4261
598,2015-05-27,51.99,121110,87448,450747,484409,1143714,2356,1066,448,464,4334
599,2015-05-28,52.6,129817,89849,519514,559482,1298662,2325,1121,463,481,4390
600,2015-05-29,52.31,127020,87233,525615,565402,1305270,2359,1132,473,487,4451
601,2015-06-01,53.625,131257,93418,536843,574682,1336200,2353,1144,488,496,4481
602,2015-06-02,52.78,131568,102117,555071,584522,1373278,2350,1193,499,502,4544
603,2015-06-03,54.3,137905,97181,640109,680833,1556028,2330,1217,517,519,4583
604,2015-06-04,56.46,139457,95227,648267,692497,1575448,2255,1273,531,530,4589
605,2015-06-05,56.245,149315,99491,661987,711811,1622604,2319,1313,550,549,4731
606,2015-06-08,55.995,155357,112258,680174,723273,1671062,2313,1340,557,556,4766
607,2015-06-09,55.545,163855,115113,680394,729136,1688498,2327,1350,563,569,4809
608,2015-06-10,54.331,174937,112921,681241,743257,1712356,2431,1372,571,587,4961
609,2015-06-11,54.798,175227,114630,688431,749028,1727316,2473,1407,572,584,5036
610,2015-06-15,54.5,49885,22253,356020,383652,811810,704,378,212,201,1495
611,2015-06-16,53.78,60213,27528,363100,395785,846626,827,463,232,236,1758
612,2015-06-17,53.6,62524,29225,364215,397514,853478,909,499,245,253,1906
613,2015-06-18,53.47,68344,37768,376387,406963,889462,1092,563,264,300,2219
614,2015-06-19,54.0,73600,40785,390775,423590,928750,1161,600,286,316,2363
615,2015-06-22,53.95,76731,41439,393345,428637,940152,1238,632,298,315,2483
616,2015-06-23,53.855,78065,42839,396042,431268,948214,1256,677,314,328,2575
617,2015-06-24,54.446,81328,43381,400225,438172,963106,1275,692,318,334,2619
618,2015-06-25,54.72,84359,47445,404246,441160,977210,1315,722,318,353,2708
619,2015-06-26,54.78,86538,50485,410486,446539,994048,1349,751,330,370,2800
620,2015-06-29,55.715,89773,50857,414041,452957,1007628,1407,820,335,379,2941
621,2015-06-30,55.3,89925,56194,426183,459914,1032216,1434,852,336,379,3001
622,2015-07-01,55.843,91280,57249,426919,460950,1036398,1437,886,337,383,3043
623,2015-07-02,55.53,89820,60999,430665,459486,1040970,1451,906,338,379,3074
624,2015-07-03,56.0,91215,60818,431666,462063,1045762,1494,923,356,384,3157
625,2015-07-06,56.889,96250,64667,447857,479440,1088214,1530,949,360,393,3232
626,2015-07-07,56.739,106716,67491,455825,495050,1125082,1579,993,366,406,3344
627,2015-07-08,57.513,107348,69603,456656,494401,1128008,1638,1075,364,408,3485
628,2015-07-09,57.17,109367,72263,459647,496751,1138028,1648,1098,361,414,3521
629,2015-07-10,56.429,112344,73707,460615,499252,1145918,1690,1099,369,414,3572
630,2015-07-13,56.52,115542,74523,457201,498220,1145486,1727,1117,369,411,3624
631,2015-07-14,56.414,117733,73802,456114,500045,1147694,1742,1113,371,417,3643
632,2015-07-15,56.938,55700,43596,361420,373524,834240,915,517,190,260,1882
633,2015-07-16,56.95,67277,49936,367520,384861,869594,1007,632,207,281,2127
634,2015-07-17,56.987,74251,49509,386024,410766,920550,1060,644,222,293,2219
635,2015-07-20,57.0,77076,51291,405170,430955,964492,1153,665,231,302,2351
636,2015-07-21,56.938,84533,55029,421178,450682,1011422,1229,680,246,316,2471
637,2015-07-22,57.445,87920,56236,441845,473529,1059530,1305,707,258,330,2600
638,2015-07-23,57.851,92463,59428,456742,489777,1098410,1410,746,267,337,2760
639,2015-07-24,58.425,106450,67231,464199,503418,1141298,1483,822,289,358,2952
640,2015-07-27,59.645,111882,76961,480128,515049,1184020,1488,887,310,380,3065
641,2015-07-28,60.02,116907,86611,488015,518311,1209844,1491,975,328,405,3199
642,2015-07-29,58.67,118348,88594,496215,525969,1229126,1585,1027,341,408,3361
643,2015-07-30,59.748,121181,88734,503809,536256,1249980,1624,1030,341,405,3400
644,2015-07-31,61.72,122464,89989,510754,543229,1266436,1549,1054,356,423,3382
645,2015-08-03,63.515,138965,103273,521993,557685,1321916,1642,1162,395,457,3656
646,2015-08-04,63.07,146371,108800,539938,577509,1372618,1736,1215,427,466,3844
647,2015-08-05,63.461,148411,112981,545305,580735,1387432,1760,1250,447,482,3939
648,2015-08-06,64.02,156000,117460,555570,594110,1423140,1811,1318,472,497,4098
649,2015-08-07,64.045,158167,118238,558836,598765,1434006,1843,1361,487,502,4193
650,2015-08-10,62.81,162272,126017,590816,627071,1506176,1872,1417,501,511,4301
651,2015-08-11,64.28,167707,131688,599454,635473,1534322,1896,1453,502,528,4379
652,2015-08-12,64.21,178144,133946,601722,645920,1559732,1876,1482,504,541,4403
653,2015-08-13,64.705,183315,137261,617205,663259,1601040,1899,1512,516,546,4473
654,2015-08-14,64.997,195310,138542,628438,685206,1647496,1890,1503,514,562,4469
655,2015-08-17,65.51,107611,92981,563440,578070,1342102,1165,779,336,327,2607
656,2015-08-18,65.881,124112,103743,577302,597671,1402828,1325,873,351,366,2915
657,2015-08-19,66.605,141383,126704,640729,655408,1564224,1409,935,377,391,3112
658,2015-08-20,67.959,151324,130603,603039,623760,1508726,1531,1002,389,404,3326
659,2015-08-21,69.108,171126,134341,610046,646831,1562344,1630,1067,415,436,3548
660,2015-08-24,70.9,210467,150443,618168,678192,1657270,1939,1188,458,465,4050
661,2015-08-25,68.85,232201,158786,634613,708028,1733628,2073,1203,479,494,4249
662,2015-08-26,68.901,227241,161335,646704,712610,1747890,2189,1250,496,512,4447
663,2015-08-27,66.009,213003,158410,655885,710478,1737776,2363,1280,519,527,4689
664,2015-08-28,65.402,239044,179964,660212,719292,1798512,2489,1298,538,554,4879
665,2015-08-31,64.249,240520,179931,662304,722893,1805648,2484,1337,531,575,4927
666,2015-09-01,66.85,241518,189335,692460,744643,1867956,2607,1418,556,587,5168
667,2015-09-02,67.079,241565,184869,689557,746253,1862244,2552,1482,550,609,5193
668,2015-09-03,67.2,228421,184429,701488,745480,1859818,2534,1496,545,614,5189
669,2015-09-04,68.42,235037,185037,704967,754967,1880008,2571,1523,546,627,5267
670,2015-09-07,69.114,242451,185729,704188,760910,1893278,2534,1573,560,638,5305
671,2015-09-08,67.99,249913,189575,703137,763475,1906100,2567,1587,559,644,5357
672,2015-09-09,68.485,242371,191511,710134,760994,1905010,2576,1611,559,647,5393
673,2015-09-10,67.668,262837,208788,560759,614808,1647192,2578,1638,556,662,5434
674,2015-09-11,67.924,250196,190273,562766,622689,1625924,2595,1608,570,674,5447
675,2015-09-14,67.49,261979,188180,570743,644542,1665444,2611,1551,580,697,5439
676,2015-09-15,66.7,38824,35605,204255,207474,486158,754,404,196,249,1603
677,2015-09-16,65.33,49895,45984,207812,211723,515414,1024,575,220,288,2107
678,2015-09-17,65.437,64874,52720,209683,221837,549114,1178,628,229,307,2342
679,2015-09-18,66.502,71375,55112,217233,233496,577216,1273,681,255,315,2524
680,2015-09-21,65.988,67345,57838,222838,232345,580366,1288,714,271,326,2599
681,2015-09-22,66.022,70395,62143,228056,236308,596902,1333,739,281,337,2690
682,2015-09-23,66.42,73452,64290,247991,257153,642886,1399,769,294,351,2813
683,2015-09-24,66.099,79032,65727,251711,265016,661486,1417,793,300,364,2874
684,2015-09-25,65.53,80973,67060,252832,266745,667610,1490,826,302,370,2988
685,2015-09-28,66.085,84456,68859,253208,268805,675328,1557,842,307,379,3085
686,2015-09-29,65.73,86262,70966,262910,278206,698344,1621,849,316,379,3165
687,2015-09-30,65.39,93072,78210,266053,280915,718250,1658,887,331,386,3262
688,2015-10-01,65.65,95470,79076,268969,285363,728878,1675,914,342,393,3324
689,2015-10-02,66.012,99182,80444,272475,291213,743314,1685,932,351,390,3358
690,2015-10-05,64.749,106971,86230,273286,294027,760514,1774,985,360,393,3512
691,2015-10-06,63.33,109745,88013,275400,297132,770290,1869,1031,372,406,3678
692,2015-10-07,62.664,113710,103235,296329,306804,820078,2095,1084,421,428,4028
693,2015-10-08,61.37,117264,105370,307071,318965,848670,2227,1122,427,440,4216
694,2015-10-09,61.876,128353,112233,296122,312242,848950,2451,1186,447,458,4542
695,2015-10-12,62.275,141609,115929,298713,324393,880644,2569,1239,458,469,4735
696,2015-10-13,63.039,160618,127408,306804,340014,934844,2679,1402,481,491,5053
697,2015-10-14,62.709,164006,125372,311424,350058,950860,2732,1439,508,492,5171
698,2015-10-15,61.403,57672,52345,212315,217642,539974,1447,803,276,301,2827
699,2015-10-16,61.285,68822,66613,224288,226497,586220,1633,974,324,327,3258
700,2015-10-19,62.262,90856,71377,227080,246559,635872,1726,1039,339,334,3438
701,2015-10-20,62.115,103576,79588,239441,263429,686034,1816,1080,351,349,3596
702,2015-10-21,63.005,111208,85473,252942,278677,728300,1847,1147,354,371,3719
703,2015-10-22,62.591,128422,97714,265921,296629,788686,1953,1178,363,377,3871
704,2015-10-23,62.38,133198,100759,268157,300596,802710,2005,1190,367,376,3938
705,2015-10-26,63.02,148265,105147,269793,312911,836116,2057,1221,371,382,4031
706,2015-10-27,64.9,155985,107889,325409,373505,962788,2132,1256,391,417,4196
707,2015-10-28,63.95,174263,113481,328415,389197,1005356,2274,1319,392,435,4420
708,2015-10-29,64.4,175646,116591,330678,389733,1012648,2285,1354,405,436,4480
709,2015-10-30,63.958,174817,116558,335149,393408,1019932,2353,1359,406,449,4567
710,2015-11-02,63.665,175937,120447,336029,391519,1023932,2391,1388,415,454,4648
711,2015-11-03,62.628,179809,124392,337683,393100,1034984,2416,1409,408,460,4693
712,2015-11-05,63.45,182316,125477,337511,394350,1039654,2474,1446,420,457,4797
713,2015-11-06,64.598,186154,129541,339465,396078,1051238,2436,1466,420,478,4800
714,2015-11-09,64.59,186761,129820,339785,396726,1053092,2457,1486,421,484,4848
715,2015-11-10,64.56,189091,132538,341244,397797,1060670,2477,1530,423,499,4929
716,2015-11-11,65.415,192831,138114,349653,404370,1084968,2498,1538,432,505,4973
717,2015-11-12,66.635,213146,141047,352630,424729,1131552,2562,1584,460,542,5148
718,2015-11-13,66.777,219275,145670,356275,429880,1151100,2576,1602,471,560,5209
719,2015-11-16,65.27,226667,144232,359916,442351,1173166,2652,1645,465,562,5324
720,2015-11-17,65.148,235897,150263,370739,456373,1213272,2773,1662,470,572,5477
721,2015-11-18,64.753,257488,161327,374417,470578,1263810,2876,1685,492,583,5636
722,2015-11-19,64.618,185104,96507,304348,392945,978904,1971,939,348,372,3630
723,2015-11-20,64.75,191078,99338,315909,407649,1013974,2122,1001,359,394,3876
724,2015-11-23,65.836,196265,103724,324681,417222,1041892,2188,1049,377,409,4023
725,2015-11-24,65.452,202176,110082,330409,422503,1065170,2250,1093,380,429,4152
726,2015-11-25,65.525,204701,127737,345070,422034,1099542,2290,1129,386,439,4244
727,2015-11-26,65.837,216491,133737,349572,432326,1132126,2354,1120,395,443,4312
728,2015-11-27,66.48,216835,136458,351948,432325,1137566,2358,1150,397,448,4353
729,2015-11-30,66.49,228946,139748,353782,442980,1165456,2406,1183,410,463,4462
730,2015-12-01,66.61,241609,144666,359112,456055,1201442,2397,1193,418,470,4478
731,2015-12-02,67.5,264616,148109,470851,587358,1470934,2416,1204,432,497,4549
732,2015-12-03,67.508,268587,153908,475466,590145,1488106,2380,1260,457,507,4604
733,2015-12-04,68.135,283931,162076,441793,563648,1451448,2400,1297,475,524,4696
734,2015-12-07,69.499,292695,168043,456881,581533,1499152,2424,1320,486,537,4767
735,2015-12-08,69.4,306599,168532,466825,604892,1546848,2477,1339,518,540,4874
736,2015-12-09,69.368,318529,177653,483702,624578,1604462,2548,1337,528,543,4956
737,2015-12-10,69.15,327555,178495,484542,633602,1624194,2605,1355,529,539,5028
738,2015-12-11,70.362,325734,175942,472300,622092,1596068,2641,1379,533,544,5097
739,2015-12-14,70.555,327328,172257,461421,616492,1577498,2682,1368,528,563,5141
740,2015-12-15,69.941,64302,36383,198854,226773,526312,763,463,200,210,1636
741,2015-12-16,70.396,78565,41308,206423,243680,569976,978,536,205,226,1945
742,2015-12-17,71.183,86720,54257,213518,245981,600476,1071,588,221,240,2120
743,2015-12-18,70.948,88185,55922,216219,248482,608808,1203,662,226,252,2343
744,2015-12-21,71.233,93735,60490,249900,283145,687270,1282,690,240,266,2478
745,2015-12-22,71.233,94779,61956,257089,289912,703736,1312,719,245,276,2552
746,2015-12-23,69.8,95657,67592,272671,300736,736656,1337,752,251,286,2626
747,2015-12-24,70.24,95682,74465,361444,382661,914252,1382,795,269,310,2756
748,2015-12-25,70.689,96587,74431,361430,383586,916034,1409,812,262,319,2802
749,2015-12-28,72.225,102559,74274,374103,402388,953324,1468,832,284,326,2910
750,2015-12-29,72.205,106145,76970,383492,412667,979274,1515,866,288,324,2993
751,2015-12-30,73.59,113028,81741,408291,439578,1042638,1568,905,303,333,3109
752,2016-01-04,73.16,115537,80747,409748,444538,1050570,1632,921,317,339,3209
753,2016-01-05,73.316,117252,80922,420331,456661,1075166,1666,928,324,339,3257
754,2016-01-06,74.76,115652,85991,422715,452376,1076734,1668,978,330,353,3329
755,2016-01-11,76.211,129112,87255,422989,464846,1104202,1757,1004,366,361,3488
756,2016-01-12,77.065,140778,92247,436648,485179,1154852,1828,1057,377,378,3640
757,2016-01-13,76.677,144692,102829,447374,489237,1184132,1924,1099,403,389,3815
758,2016-01-14,76.051,147693,107143,456602,497152,1208590,1999,1132,411,402,3944
759,2016-01-15,77.603,156318,111527,491630,536421,1295896,2023,1161,430,426,4040
760,2016-01-18,79.29,174871,111287,505999,569583,1361740,2088,1231,446,432,4197
761,2016-01-19,78.561,198694,123381,517202,592515,1431792,2139,1270,452,440,4301
762,2016-01-20,81.4,206737,116110,542451,633078,1498376,2129,1316,495,460,4400
763,2016-01-21,82.63,102229,63966,415529,453792,1035516,1347,787,305,310,2749
764,2016-01-22,78.024,114215,81946,474649,506918,1177728,1804,1054,340,358,3556
765,2016-01-25,80.04,129969,95347,524713,559335,1309364,1944,1166,359,399,3868
766,2016-01-26,78.3,145028,103719,548502,589811,1387060,2094,1338,388,419,4239
767,2016-01-27,77.667,153955,107983,551983,597955,1411876,2202,1401,394,430,4427
768,2016-01-28,76.397,175466,112389,555655,618732,1462242,2399,1495,401,439,4734
769,2016-01-29,75.43,182387,117135,555884,621136,1476542,2493,1581,413,462,4949
770,2016-02-01,77.31,190622,120903,575152,644871,1531548,2581,1650,430,472,5133
771,2016-02-02,79.755,197552,123687,569525,643390,1534154,2571,1739,434,478,5222
772,2016-02-03,76.904,207032,126561,571727,652198,1557518,2645,1781,442,483,5351
773,2016-02-04,76.969,222598,131683,571747,662662,1588690,2809,1797,444,495,5545
774,2016-02-05,77.47,230269,132495,566416,664190,1593370,2860,1859,448,513,5680
775,2016-02-08,78.544,237645,139480,571475,669640,1618240,2893,1890,458,514,5755
776,2016-02-09,79.701,250369,144904,567972,673437,1636682,2880,1911,470,529,5790
777,2016-02-10,78.606,264938,152710,571519,683747,1672914,2935,1929,474,538,5876
778,2016-02-11,79.592,260386,156253,578765,682898,1678302,2883,1983,478,544,5888
779,2016-02-12,78.34,280693,163315,576952,694330,1715290,2997,2037,491,557,6082
780,2016-02-15,76.95,314758,170655,577504,721607,1784524,3064,2052,502,580,6198
781,2016-02-16,77.899,327617,180247,581219,728589,1817672,3113,2105,516,582,6316
782,2016-02-17,75.032,367975,187085,614038,794928,1964026,3249,2105,537,614,6505
783,2016-02-18,76.5,255548,128955,551220,677813,1613536,1915,1076,379,352,3722
784,2016-02-19,76.986,277393,140018,567614,704989,1690014,2040,1254,410,368,4072
785,2016-02-20,77.05,279119,140159,569267,708227,1696772,2106,1302,414,367,4189
786,2016-02-22,75.3,278739,140718,571154,709175,1699786,2199,1366,422,373,4360
787,2016-02-24,75.711,280308,149973,579983,710318,1720582,2217,1492,438,395,4542
788,2016-02-25,75.385,279833,150189,580750,710394,1721166,2364,1504,445,403,4716
789,2016-02-26,76.2,284811,167092,597926,715645,1765474,2512,1564,453,416,4945
790,2016-02-29,75.2,291224,164819,593628,720033,1769704,2506,1613,449,428,4996
791,2016-03-01,73.392,296566,171963,594857,719460,1782846,2679,1781,457,458,5375
792,2016-03-02,73.07,299973,193841,620342,726474,1840630,2834,1877,493,481,5685
793,2016-03-03,73.171,315540,199196,629362,745706,1889804,2920,1942,511,487,5860
794,2016-03-04,71.97,333556,210737,641591,764410,1950294,3101,1984,519,518,6122
795,2016-03-07,71.471,333930,215720,646987,765197,1961834,3272,2065,522,556,6415
796,2016-03-09,71.141,340556,222749,646098,763905,1973308,3503,2152,546,591,6792
797,2016-03-10,71.455,360697,223893,654857,791661,2031108,3691,2266,593,606,7156
798,2016-03-11,69.883,386798,223487,658933,822244,2091462,4069,2280,620,616,7585
799,2016-03-14,69.96,414554,238647,683857,859764,2196822,4210,2334,634,640,7818
800,2016-03-15,71.04,61791,42135,94011,113667,311604,1194,640,201,212,2247
801,2016-03-16,69.123,89041,67760,100686,121967,379454,1435,775,213,240,2663
802,2016-03-17,68.1,111300,79032,114704,146972,452008,1873,1006,251,288,3418
803,2016-03-18,68.389,133044,93145,136240,176139,538568,2107,1138,288,307,3840
804,2016-03-21,67.822,148917,110672,147532,185777,592898,2282,1241,314,338,4175
805,2016-03-22,67.5,161469,116525,157519,202463,637976,2416,1284,332,359,4391
806,2016-03-23,68.737,187352,148747,179433,218038,733570,2631,1426,408,371,4836
807,2016-03-24,68.527,188134,151875,185657,221916,747582,2592,1505,413,390,4900
808,2016-03-25,68.454,191071,156297,191557,226331,765256,2702,1544,423,394,5063
809,2016-03-28,68.47,194096,158693,200605,236008,789402,2795,1575,431,410,5211
810,2016-03-29,68.05,203347,163162,215452,255637,837598,2906,1627,437,420,5390
811,2016-03-30,68.24,223935,164149,220099,279885,888068,3068,1638,442,415,5563
812,2016-03-31,67.025,227587,166990,230690,291287,916554,3220,1695,472,413,5800
813,2016-04-01,67.595,229391,165085,235077,299383,928936,3224,1723,483,425,5855
814,2016-04-04,68.7,237519,163216,242658,316961,960354,3334,1716,492,435,5977
815,2016-04-05,68.562,238619,163374,244425,319670,966088,3287,1754,509,435,5985
816,2016-04-06,67.59,245282,166439,245141,323984,980846,3418,1779,511,445,6153
817,2016-04-07,68.028,255325,165726,253201,342800,1017052,3470,1801,522,456,6249
818,2016-04-08,67.15,264738,174031,256963,347670,1043402,3587,1809,528,465,6389
819,2016-04-11,66.773,279841,183845,264479,360475,1088640,3680,1832,531,477,6520
820,2016-04-12,65.715,291963,190357,270824,372430,1125574,3807,1855,541,488,6691
821,2016-04-13,66.31,310967,206421,294219,398765,1210372,3941,1921,563,511,6936
822,2016-04-14,66.11,321334,211512,309384,419206,1261436,4038,1943,575,522,7078
823,2016-04-15,66.447,329982,218333,470054,581703,1600072,4110,1957,582,527,7176
824,2016-04-18,66.118,338602,233548,480764,585818,1638732,4162,2032,587,543,7324
825,2016-04-19,65.853,346623,233079,495300,608844,1683846,4294,2081,591,559,7525
826,2016-04-20,65.157,354209,235548,496154,614815,1700726,4362,2110,608,577,7657
827,2016-04-21,66.84,93546,74768,401525,420303,990142,1869,1023,351,308,3551
828,2016-04-22,66.455,107380,86238,421234,442376,1057228,2073,1163,373,339,3948
829,2016-04-25,66.567,113420,91002,428493,450911,1083826,2219,1270,389,352,4230
830,2016-04-26,65.2,121212,99389,443734,465557,1129892,2398,1314,399,358,4469
831,2016-04-27,65.12,133463,103272,446175,476366,1159276,2576,1369,410,362,4717
832,2016-04-28,64.719,149123,116937,466180,498366,1230606,2793,1417,418,377,5005
833,2016-04-29,64.63,164654,121767,487471,530358,1304250,2937,1458,432,395,5222
834,2016-05-04,66.529,165398,122570,500075,542903,1330946,2920,1498,452,398,5268
835,2016-05-05,65.89,172923,127783,505288,550428,1356422,3053,1526,452,420,5451
836,2016-05-06,65.945,173106,132489,508485,549102,1363182,3097,1553,460,421,5531
837,2016-05-10,66.31,196062,138372,508082,565772,1408288,3150,1590,453,422,5615
838,2016-05-11,64.978,203538,142279,510666,571925,1428408,3222,1613,468,431,5734
839,2016-05-12,64.895,204935,140595,515563,579903,1440996,3369,1651,475,450,5945
840,2016-05-13,65.48,209206,147186,525369,587389,1469150,3473,1678,481,460,6092
841,2016-05-16,64.9,223261,155224,526820,594857,1500162,3549,1705,490,473,6217
842,2016-05-17,64.72,256423,162893,586992,680522,1686830,3691,1744,509,483,6427
843,2016-05-18,65.999,269920,168015,592479,694384,1724798,3753,1754,528,472,6507
844,2016-05-19,66.78,144131,114361,547308,577078,1382878,2360,1160,421,370,4311
845,2016-05-20,66.798,156924,123961,550157,583120,1414162,2532,1293,427,389,4641
846,2016-05-23,66.808,163088,125242,562739,600585,1451654,2641,1370,439,396,4846
847,2016-05-24,66.184,165801,133860,569827,601768,1471256,2703,1427,443,406,4979
848,2016-05-25,65.508,179466,142670,577946,614742,1514824,2927,1447,453,417,5244
849,2016-05-26,65.801,184932,144650,577065,617347,1523994,3053,1490,455,429,5427
850,2016-05-27,66.144,190419,148908,584468,625979,1549774,3101,1518,462,430,5511
851,2016-05-30,65.75,196169,158921,593136,630384,1578610,3164,1556,474,431,5625
852,2016-05-31,66.7,202444,159901,594814,637357,1594516,3233,1575,479,438,5725
853,2016-06-01,67.14,201647,164170,604262,641739,1611818,3204,1633,485,451,5773
854,2016-06-02,66.96,215892,172031,631617,675478,1695018,3299,1686,492,453,5930
855,2016-06-03,65.62,234829,179547,645208,700490,1760074,3444,1701,507,451,6103
856,2016-06-06,65.245,248120,188033,657240,717327,1810720,3617,1724,509,468,6318
857,2016-06-07,64.6225,261662,189105,656311,728868,1835946,3737,1723,522,480,6462
858,2016-06-08,63.61,287992,196135,651643,743500,1879270,4024,1808,533,518,6883
859,2016-06-09,64.3275,316511,211608,650753,755656,1934528,4128,1849,530,533,7040
860,2016-06-10,65.28,315438,213485,655933,757886,1942742,4091,1883,535,528,7037
861,2016-06-14,66.14,305022,205998,663036,762060,1936116,3951,1934,542,530,6957
862,2016-06-15,65.5125,55214,63298,66326,58242,243080,1049,802,190,229,2270
863,2016-06-16,65.78,62530,70099,78184,70615,281428,1237,954,207,254,2652
864,2016-06-17,64.85,71087,78964,91776,83899,325726,1417,1064,216,276,2973
865,2016-06-20,64.2975,81892,86321,94889,90460,353562,1551,1136,225,283,3195
866,2016-06-21,63.755,90399,90971,96149,95577,373096,1711,1210,239,287,3447
867,2016-06-22,64.89,100004,91261,97533,106276,395074,1826,1281,243,296,3646
868,2016-06-23,63.85,111060,94856,101571,117775,425262,1953,1330,262,299,3844
869,2016-06-24,65.2625,121973,105183,107272,124062,458490,2020,1392,271,305,3988
870,2016-06-27,65.4875,123062,110485,111895,124472,469914,2062,1424,275,307,4068
871,2016-06-28,64.1,129866,116020,116935,130781,493602,2158,1486,280,310,4234
872,2016-06-29,63.85,136510,120707,126500,142303,526020,2319,1544,297,326,4486
873,2016-06-30,63.99,150435,124202,128345,154578,557560,2427,1555,303,336,4621
874,2016-07-01,63.8,165232,138750,141305,167787,613074,2496,1597,309,337,4739
875,2016-07-04,63.935,183025,137579,149051,194497,664152,2587,1631,313,349,4880
876,2016-07-05,64.3175,201897,142183,162216,221930,728226,2617,1676,324,355,4972
877,2016-07-06,64.2075,211181,148026,172593,235748,767548,2664,1683,338,363,5048
878,2016-07-07,64.565,221688,143777,173417,251328,790210,2767,1671,343,373,5154
879,2016-07-08,63.98,249125,146305,185756,288576,869762,2892,1660,341,392,5285
880,2016-07-11,64.2,261018,150237,186639,297420,895314,2917,1691,350,401,5359
881,2016-07-12,63.89,279229,155257,187422,311394,933302,2977,1692,359,394,5422
882,2016-07-13,63.85,287371,157831,186640,316180,948022,3080,1715,361,402,5558
883,2016-07-14,62.85,308517,169700,182953,321770,982940,3323,1765,374,413,5875
884,2016-07-15,63.51,315483,180424,191023,326082,1013012,3390,1795,389,428,6002
885,2016-07-18,62.8425,337877,191764,198336,344449,1072426,3517,1815,388,434,6154
886,2016-07-19,63.5475,352588,197334,195766,351020,1096708,3526,1819,394,443,6182
887,2016-07-20,63.74,361418,207838,206859,360439,1136554,3581,1905,413,450,6349
888,2016-07-21,64.37,107545,98144,125943,135344,466976,1775,1034,263,265,3337
889,2016-07-22,64.88,145880,109791,141569,177658,574898,1984,1236,285,299,3804
890,2016-07-25,65.415,158034,126251,153314,185097,622696,2088,1341,295,321,4045
891,2016-07-26,65.9475,166435,134154,156577,188858,646024,2165,1492,297,338,4292
892,2016-07-27,65.9275,178581,135474,154084,197191,665330,2286,1523,298,363,4470
893,2016-07-28,66.615,188297,139844,163300,211753,703194,2348,1580,314,382,4624
894,2016-07-29,66.035,168270,149037,176686,195919,689912,2486,1624,330,383,4823
895,2016-08-01,66.895,187700,154727,178379,211352,732158,2551,1655,341,386,4933
896,2016-08-02,66.6475,200504,159100,174428,215832,749864,2619,1719,345,386,5069
897,2016-08-03,66.27,209531,163626,180791,226696,780644,2686,1769,397,392,5244
898,2016-08-04,65.7875,218292,167468,182743,233567,802070,2770,1789,406,396,5361
899,2016-08-05,65.5475,234385,169741,186257,250901,841284,2947,1782,404,406,5539
900,2016-08-08,64.615,247197,172168,184897,259926,864188,3092,1815,417,407,5731
901,2016-08-09,64.765,257831,173912,188089,272008,891840,3202,1822,427,420,5871
902,2016-08-10,64.87,282266,180292,192261,294235,949054,3355,1821,425,423,6024
903,2016-08-11,64.325,282205,183678,200849,299376,966108,3395,1840,430,435,6100
904,2016-08-12,64.75,289266,184673,199824,304417,978180,3421,1877,442,445,6185
905,2016-08-15,64.03,310410,185392,194590,319608,1010000,3571,1869,443,448,6331
906,2016-08-16,63.775,338958,192343,195003,341618,1067922,3693,1857,453,458,6461
907,2016-08-17,63.825,350607,196409,198312,352510,1097838,3734,1885,464,452,6535
908,2016-08-18,63.65,199125,114840,147028,231313,692306,2532,1214,348,304,4398
909,2016-08-19,63.9,210381,125611,153484,238254,727730,2728,1349,350,321,4748
910,2016-08-22,64.8125,247126,143010,190266,294382,874784,2813,1429,359,332,4933
911,2016-08-23,64.6,252888,151278,206860,308470,919496,2870,1487,359,340,5056
912,2016-08-24,65.17,258318,152997,211713,317034,940062,2843,1530,367,348,5088
913,2016-08-25,64.6625,266271,158669,213028,320630,958598,2952,1564,367,359,5242
914,2016-08-26,64.86,286111,162248,210755,334618,993732,3029,1562,376,372,5339
915,2016-08-29,64.75,285232,165554,219700,339378,1009864,3007,1578,381,380,5346
916,2016-08-30,65.25,296713,164909,216575,348379,1026576,3026,1586,386,385,5383
917,2016-08-31,65.315,304767,168911,221546,357402,1052626,3103,1593,390,388,5474
918,2016-09-01,65.92,307722,170781,223671,360612,1062786,3049,1644,395,403,5491
919,2016-09-02,65.095,311665,177422,231867,366110,1087064,3138,1657,390,413,5598
920,2016-09-05,65.08,316979,176095,224950,365834,1083858,3221,1671,394,425,5711
921,2016-09-06,64.5625,326682,186963,235299,375018,1123962,3275,1688,400,428,5791
922,2016-09-07,64.135,334709,195662,238328,377375,1146074,3352,1681,402,432,5867
923,2016-09-08,63.9975,349268,204619,239842,384491,1178220,3499,1738,414,444,6095
924,2016-09-09,64.82,331100,200751,249937,380286,1162074,3473,1770,424,450,6117
925,2016-09-12,64.5875,330003,202776,250186,377413,1160378,3404,1798,430,455,6087
926,2016-09-13,65.2975,336783,205470,265217,396530,1204000,3404,1837,431,465,6137
927,2016-09-14,65.16,344788,206709,263269,401348,1216114,3422,1833,438,469,6162
928,2016-09-15,64.775,82396,68926,57633,71103,280058,1230,759,168,201,2358
929,2016-09-16,65.12,113409,92450,75485,96444,377788,1434,891,191,228,2744
930,2016-09-19,64.65,131987,108625,88122,111484,440218,1609,995,205,247,3056
931,2016-09-20,64.7775,139821,115547,90259,114533,460160,1747,1070,218,255,3290
932,2016-09-21,63.81,148146,119544,93544,122146,483380,1891,1141,232,264,3528
933,2016-09-22,63.7025,166236,133139,106256,139353,544984,2178,1233,257,274,3942
934,2016-09-23,64.06,173612,136573,107346,144385,561916,2276,1278,260,284,4098
935,2016-09-26,63.95,186358,143026,111692,155024,596100,2389,1309,277,282,4257
936,2016-09-27,63.86,198120,145774,114872,167218,625984,2503,1344,284,298,4429
937,2016-09-28,63.04,222669,149043,121978,195604,689294,2663,1389,295,310,4657
938,2016-09-29,63.08,242368,152899,124931,214400,734598,2913,1452,303,326,4994
939,2016-09-30,62.805,253953,163316,132423,223060,772752,3008,1481,326,321,5136
940,2016-10-03,62.29,273964,175894,143214,241284,834356,3262,1554,334,340,5490
941,2016-10-04,62.665,287669,182957,160478,265190,896294,3351,1591,341,367,5650
942,2016-10-05,62.4375,319594,192144,183734,311184,1006656,3436,1625,338,371,5770
943,2016-10-06,62.13,335959,206132,191897,321724,1055712,3538,1666,343,380,5927
944,2016-10-07,62.2125,350583,212683,206306,344206,1113778,3674,1700,369,391,6134
945,2016-10-10,62.005,359462,225866,219575,353171,1158074,3759,1713,382,405,6259
946,2016-10-11,62.6625,355072,222440,224023,356655,1158190,3743,1769,385,408,6305
947,2016-10-12,63.02,362751,236114,233320,359957,1192142,3742,1816,394,410,6362
948,2016-10-13,63.03,383217,243762,227252,366707,1220938,3755,1847,402,420,6424
949,2016-10-14,62.96,386234,250247,239025,375012,1250518,3798,1862,407,428,6495
950,2016-10-17,63.11,396850,254038,250055,392867,1293810,3809,1929,416,437,6591
951,2016-10-18,62.81,405342,257420,258048,405970,1326780,3818,1946,420,426,6610
952,2016-10-19,62.285,408341,252035,251021,407327,1318724,3874,1971,436,446,6727
953,2016-10-20,62.4875,190934,165508,121939,147365,625746,2101,1212,273,288,3874
954,2016-10-21,62.37,205395,175617,127898,157676,666586,2272,1359,290,306,4227
955,2016-10-24,62.1825,216492,184684,132309,164117,697602,2416,1449,311,313,4489
956,2016-10-25,62.24,222105,193208,140267,169164,724744,2535,1517,317,322,4691
957,2016-10-26,62.91,228963,198213,142953,173703,743832,2599,1606,322,329,4856
958,2016-10-27,62.7025,241650,212613,151838,180875,786976,2684,1680,331,342,5037
959,2016-10-28,63.02,244061,214088,153788,183761,795698,2713,1697,333,346,5089
960,2016-10-31,63.375,254064,218107,155794,191751,819716,2754,1750,332,351,5187
961,2016-11-01,63.32,266396,222103,167560,211853,867912,2831,1782,350,355,5318
962,2016-11-02,63.515,307254,244741,203337,265850,1021182,2859,1821,359,367,5406
963,2016-11-03,63.58,315605,255374,221430,281661,1074070,2907,1879,360,379,5525
964,2016-11-07,63.6325,317689,262401,239551,294839,1114480,2988,1914,368,392,5662
965,2016-11-08,63.7625,332611,270905,266157,327863,1197536,3040,1932,375,395,5742
966,2016-11-09,63.89,337505,269752,270993,338746,1216996,3058,1941,372,406,5777
967,2016-11-10,65.4725,341443,264277,273126,350292,1229138,3018,1953,382,395,5748
968,2016-11-11,65.72,390312,274947,265327,380692,1311278,3087,2100,401,410,5998
969,2016-11-14,66.0325,394213,279807,267076,381482,1322578,3160,2147,404,419,6130
970,2016-11-15,64.195,410628,293967,273138,389799,1367532,3315,2177,419,409,6320
971,2016-11-16,64.7175,435589,300373,257677,392893,1386532,3419,2239,417,410,6485
972,2016-11-17,64.8,231652,193264,158159,196547,779622,2464,1495,307,277,4543
973,2016-11-18,64.7025,238593,202328,166900,203165,810986,2579,1619,324,299,4821
974,2016-11-21,63.91,247269,217666,184098,213701,862734,2746,1678,337,315,5076
975,2016-11-22,63.7825,259057,228286,187926,218697,893966,2816,1745,349,325,5235
976,2016-11-23,64.4625,260590,230208,188219,218601,897618,2847,1793,355,331,5326
977,2016-11-24,64.485,263191,232177,188050,219064,902482,2932,1830,361,340,5463
978,2016-11-25,64.95,267424,233075,185068,219417,904984,2972,1851,368,347,5538
979,2016-11-28,64.84,316250,235505,218605,299350,1069710,3100,1874,378,358,5710
980,2016-11-29,65.1125,319710,240943,233954,312721,1107328,3132,1891,389,363,5775
981,2016-11-30,64.14,325965,249815,237577,313727,1127084,3270,1917,395,394,5976
982,2016-12-01,63.98,336821,264413,235678,308086,1144998,3363,1955,408,399,6125
983,2016-12-02,63.88,339081,272242,245057,311896,1168276,3394,1983,407,412,6196
984,2016-12-05,63.82,341684,273581,251434,319537,1186236,3453,1992,413,414,6272
985,2016-12-06,63.8725,348697,271141,243000,320556,1183394,3492,2004,413,417,6326
986,2016-12-07,63.2275,354410,268094,249111,335427,1207042,3527,2018,418,423,6386
987,2016-12-08,63.28,369014,277321,244440,336133,1226908,3596,2056,424,419,6495
988,2016-12-09,62.495,381771,286261,250805,346315,1265152,3632,2107,438,443,6620
989,2016-12-12,61.05,415516,317906,304287,401897,1439606,3984,2228,479,487,7178
990,2016-12-13,60.605,462406,337079,346109,471436,1617030,4237,2297,509,508,7551
991,2016-12-14,62.1,483558,347298,363665,499925,1694446,4473,2312,521,526,7832
992,2016-12-15,61.7475,63629,75506,154239,142362,435736,1224,712,182,233,2351
993,2016-12-16,62.0825,77577,94706,179103,161974,513360,1368,800,194,261,2623
994,2016-12-19,61.9475,81905,112456,195578,165027,554966,1488,892,210,276,2866
995,2016-12-20,61.46,84724,148114,237257,173867,643962,1585,1011,230,287,3113
996,2016-12-21,61.1675,91540,173707,261802,179635,706684,1731,1106,232,297,3366
997,2016-12-22,60.965,101781,186143,267769,183407,739100,1888,1189,232,296,3605
998,2016-12-23,61.04,116400,201730,280821,195491,794442,1940,1221,248,297,3706
999,2016-12-26,60.99,118317,209650,292603,201270,821840,2024,1265,257,303,3849
1000,2016-12-26,60.99,118317,209650,292603,201270,821840,2024,1265,257,303,3849
1001,2016-12-27,60.67,131446,228518,301959,204887,866810,2104,1303,255,310,3972
1002,2016-12-28,60.335,141212,239157,312589,214644,907602,2204,1363,263,315,4145
1003,2016-12-29,60.4,148548,247571,332631,233608,962358,2276,1402,264,332,4274
1004,2016-12-30,61.2725,155843,260907,368474,263410,1048634,2296,1435,279,327,4337
1005,2017-01-03,60.9025,166669,261778,376963,281854,1087264,2379,1430,274,340,4423
1006,2017-01-04,60.46,173541,266680,383212,290073,1113506,2411,1477,289,339,4516
1007,2017-01-05,59.45,190313,273806,388438,304945,1157502,2602,1570,295,356,4823
1008,2017-01-06,59.62,198052,280206,393422,311268,1182948,2681,1642,304,371,4998
1009,2017-01-09,60.09,200948,290403,395219,305764,1192334,2710,1733,318,382,5143
1010,2017-01-10,60.1675,204919,291551,395182,308550,1200202,2746,1778,319,382,5225
1011,2017-01-11,59.7475,209909,291325,392659,311243,1205136,2764,1811,326,381,5282
1012,2017-01-12,59.3325,224844,301018,393830,317656,1237348,2974,1839,326,392,5531
1013,2017-01-13,59.66,226480,298493,396910,324897,1246780,3003,1901,331,395,5630
1014,2017-01-16,59.87,239527,293385,401914,348056,1282882,3036,1926,342,413,5717
1015,2017-01-17,59.41,252288,301002,408963,360249,1322502,3168,2013,348,424,5953
1016,2017-01-18,59.56,275915,308897,421080,388098,1393990,3227,2040,362,440,6069
1017,2017-01-19,59.72,77924,68548,105625,115001,367098,1608,1098,218,220,3144
1018,2017-01-20,59.755,94946,101572,134466,127840,458824,1825,1277,228,235,3565
1019,2017-01-23,59.5175,103424,115895,157741,145270,522330,1988,1371,240,258,3857
1020,2017-01-24,59.24,107829,130659,187470,164640,590598,2083,1447,250,276,4056
1021,2017-01-25,59.5175,138753,151386,200422,187789,678350,2241,1491,259,294,4285
1022,2017-01-26,60.4375,161404,158818,210830,213416,744468,2183,1596,269,305,4353
1023,2017-01-27,59.83,176596,168785,226717,234528,806626,2370,1642,274,317,4603
1024,2017-01-30,59.93,191697,179046,252374,265025,888142,2427,1698,272,330,4727
1025,2017-01-31,60.16,211464,188828,264606,287242,952140,2563,1743,293,321,4920
1026,2017-02-01,60.1325,225142,189278,285664,321528,1021612,2670,1740,297,328,5035
1027,2017-02-02,59.425,256778,201905,298597,353470,1110750,2823,1762,308,336,5229
1028,2017-02-03,58.9625,281327,218283,313447,376491,1189548,3095,1833,305,360,5593
1029,2017-02-06,58.9025,294512,220329,309888,384071,1208800,3301,1877,316,369,5863
1030,2017-02-07,59.32,301344,228615,314716,387445,1232120,3317,1940,318,371,5946
1031,2017-02-08,59.23,316942,238208,316851,395585,1267586,3372,1978,321,376,6047
1032,2017-02-09,58.95,330291,248857,327790,409224,1316162,3461,2004,328,389,6182
1033,2017-02-10,58.24,336557,254652,332812,414717,1338738,3604,2039,347,388,6378
1034,2017-02-13,57.98,370582,275937,335280,429925,1411724,3869,2158,360,423,6810
1035,2017-02-14,57.1075,411029,281484,341011,470556,1504080,4248,2214,384,447,7293
1036,2017-02-15,57.265,441851,311161,358527,489217,1600756,4601,2318,403,472,7794
1037,2017-02-16,57.6,228192,159912,190331,258611,837046,2920,1412,259,307,4898
1038,2017-02-17,58.4175,242495,164742,195644,273397,876278,3101,1624,299,313,5337
1039,2017-02-20,57.95,239667,169769,206307,276205,891948,3211,1686,313,332,5542
1040,2017-02-21,57.4025,248240,177326,218185,289099,932850,3318,1744,328,346,5736
1041,2017-02-22,58.0725,259715,180748,253330,332297,1026090,3401,1770,359,360,5890
1042,2017-02-24,58.445,269965,182142,256009,343832,1051948,3423,1815,360,383,5981
1043,2017-02-27,58.0525,282821,191332,268406,359895,1102454,3563,1813,352,409,6137
1044,2017-02-28,58.2875,284704,198876,291672,377500,1152752,3613,1845,365,414,6237
1045,2017-03-01,58.3075,279546,198492,305451,386505,1169994,3631,1869,378,423,6301
1046,2017-03-02,58.805,286768,201222,320186,405732,1213908,3672,1921,389,436,6418
1047,2017-03-03,58.23,291779,205897,330736,416618,1245030,3742,1950,395,448,6535
1048,2017-03-06,58.19,313916,211468,330599,433047,1289030,3894,1943,402,470,6709
1049,2017-03-07,58.18,317683,215402,340493,442774,1316352,3945,1986,403,477,6811
1050,2017-03-09,59.3175,316298,227777,375941,464462,1384478,3717,2032,404,486,6639
1051,2017-03-10,58.9975,328828,229490,382046,481384,1421748,3822,2029,414,489,6754
1052,2017-03-13,58.7725,331089,231116,387255,487228,1436688,3815,2024,418,493,6750
1053,2017-03-14,59.16,343685,227250,377979,494414,1443328,3785,2045,451,489,6770
1054,2017-03-15,58.39,358712,232815,390321,516218,1498066,3932,2065,453,488,6938
1055,2017-03-16,57.79,97681,78657,130261,149285,455884,1365,766,181,214,2526
1056,2017-03-17,57.22,112713,96513,168037,184237,561500,1633,927,202,228,2990
1057,2017-03-20,57.3025,134610,108924,178166,203852,625552,1856,1042,223,244,3365
1058,2017-03-21,57.7,142491,116579,186416,212328,657814,2042,1087,238,253,3620
1059,2017-03-22,57.7875,148137,122825,203079,228391,702432,2097,1177,247,271,3792
1060,2017-03-23,57.465,156157,130576,212409,237990,737132,2172,1214,252,273,3911
1061,2017-03-24,56.88,165698,141993,229770,253475,790936,2349,1279,262,288,4178
1062,2017-03-27,56.9025,173974,150287,248368,272055,844684,2473,1346,278,304,4401
1063,2017-03-28,57.0075,185310,156469,254167,283008,878954,2536,1368,281,307,4492
1064,2017-03-29,56.61,202660,162028,257874,298506,921068,2645,1403,286,315,4649
1065,2017-03-30,56.08,221875,183888,284561,322548,1012872,2867,1471,296,344,4978
1066,2017-03-31,56.28,222591,190193,294864,327262,1034910,2983,1536,327,343,5189
1067,2017-04-03,56.115,228832,195147,296445,330130,1050554,3085,1590,337,355,5367
1068,2017-04-04,56.09,227825,201145,310012,336692,1075674,3148,1620,341,371,5480
1069,2017-04-05,56.38,230889,211254,333372,353007,1128522,3253,1679,348,384,5664
1070,2017-04-06,56.3975,237808,217538,349576,369846,1174768,3289,1717,354,396,5756
1071,2017-04-07,57.25,228726,217498,365447,376675,1188346,3219,1760,375,404,5758
1072,2017-04-10,57.1675,241242,222818,372340,390764,1227164,3281,1769,371,423,5844
1073,2017-04-11,56.8975,258503,232190,388076,414389,1293158,3312,1759,376,423,5870
1074,2017-04-12,56.595,271566,232191,395815,435190,1334762,3358,1791,372,429,5950
1075,2017-04-13,56.2825,298054,237180,369880,430754,1335868,3438,1795,377,437,6047
1076,2017-04-14,56.3625,307611,239500,365762,433873,1346746,3568,1852,386,432,6238
1077,2017-04-17,55.9425,315995,249410,369869,436454,1371728,3684,1906,396,443,6429
1078,2017-04-18,56.25,315507,258595,373368,430280,1377750,3726,1957,394,463,6540
1079,2017-04-19,56.5675,319535,267070,377884,430349,1394838,3715,2062,402,460,6639
1080,2017-04-20,56.1975,131668,119003,154635,167300,572606,1935,1167,224,282,3608
1081,2017-04-21,56.455,147971,127394,160451,181028,616844,2086,1315,241,319,3961
1082,2017-04-24,55.8475,172609,148931,170359,194037,685936,2301,1385,254,332,4272
1083,2017-04-25,56.1675,192600,162691,192587,222496,770374,2389,1459,273,352,4473
1084,2017-04-26,57.16,196107,181588,220924,235443,834062,2342,1585,292,350,4569
1085,2017-04-27,56.9725,215083,184027,247902,278958,925970,2435,1644,301,347,4727
1086,2017-04-28,56.9225,231323,191156,264092,304259,990830,2520,1659,306,351,4836
1087,2017-05-02,57.0,236754,194144,266934,309544,1007376,2566,1687,314,362,4929
1088,2017-05-03,57.3825,240953,195336,275283,320900,1032472,2600,1697,314,367,4978
1089,2017-05-04,58.3975,253543,205100,294504,342947,1096094,2624,1762,318,371,5075
1090,2017-05-05,57.9325,264632,213568,290242,341306,1109748,2695,1847,331,380,5253
1091,2017-05-10,57.435,287522,216081,288288,359729,1151620,2777,1825,338,383,5323
1092,2017-05-11,57.05,317333,228325,289982,378990,1214630,2851,1862,345,394,5452
1093,2017-05-12,57.085,316589,229651,298169,385107,1229516,2878,1896,344,409,5527
1094,2017-05-15,56.345,331929,235270,305726,402385,1275310,2992,1925,364,417,5698
1095,2017-05-16,56.58,340885,244991,303913,399807,1289596,3089,1957,363,418,5827
1096,2017-05-17,57.085,325163,249555,308470,384078,1267266,3073,1988,360,428,5849
1097,2017-05-18,57.58,183704,149648,191332,225388,750072,2024,1278,254,305,3861
1098,2017-05-19,56.9,192112,161146,209027,239993,802278,2168,1366,266,318,4118
1099,2017-05-22,56.64,207283,174394,238166,271055,890898,2358,1475,290,341,4464
1100,2017-05-23,56.36,230207,181801,253437,301843,967288,2513,1513,306,363,4695
1101,2017-05-24,56.405,250808,194843,270951,326916,1043518,2608,1560,359,380,4907
1102,2017-05-25,56.96,262365,203764,284174,342775,1093078,2724,1594,329,389,5036
1103,2017-05-26,56.5,263692,200548,305159,368303,1137702,2772,1643,342,384,5141
1104,2017-05-29,56.45,277132,208510,322402,391024,1199068,2846,1652,344,388,5230
1105,2017-05-30,56.54,282702,223130,331045,390617,1227494,2864,1705,342,402,5313
1106,2017-05-31,56.56,298927,229189,347525,417263,1292904,2898,1729,348,403,5378
1107,2017-06-01,56.385,321312,246327,377328,452313,1397280,2969,1722,349,396,5436
1108,2017-06-02,56.6575,341410,263729,408212,485893,1499244,3013,1770,355,405,5543
1109,2017-06-05,56.6,347078,269631,416761,494208,1527678,3071,1775,360,408,5614
1110,2017-06-06,56.52,353395,268765,418235,502865,1543260,3110,1801,360,414,5685
1111,2017-06-07,57.0825,356472,270483,440651,526640,1594246,3099,1824,376,423,5722
1112,2017-06-08,56.9175,364618,272976,439817,531459,1608870,3129,1846,380,434,5789
1113,2017-06-09,57.03,356504,272888,447265,530881,1607538,3137,1860,418,438,5853
1114,2017-06-13,56.98,363596,272459,446989,538126,1621170,3157,1855,417,443,5872
1115,2017-06-14,57.435,370650,271423,469566,568793,1680432,3195,1877,417,459,5948
1116,2017-06-15,57.89,126350,106922,210324,229752,673348,1091,787,199,222,2299
1117,2017-06-16,57.77,138923,121447,229586,247062,737018,1285,938,271,242,2736
1118,2017-06-19,58.4425,148660,132429,274164,290395,845648,1376,1074,330,256,3036
1119,2017-06-20,59.6325,165925,145615,289979,310289,911808,1462,1321,354,326,3463
1120,2017-06-21,60.3225,182615,150298,299393,331710,964016,1644,1475,387,413,3919
1121,2017-06-22,59.9375,189326,161890,322898,350334,1024448,1754,1533,401,436,4124
1122,2017-06-23,59.385,196736,186238,351966,362464,1097404,1804,1580,406,445,4235
1123,2017-06-26,58.77,213651,203723,363164,373092,1153630,1926,1642,405,463,4436
1124,2017-06-27,59.49,212590,209391,373570,376769,1172320,969,565,127,119,1780
1125,2017-06-28,59.2,214192,216840,378363,375715,1185110,962,583,128,79,1752
1126,2017-06-29,59.425,220532,221854,390886,389564,1222836,1009,592,88,79,1768
1127,2017-06-30,58.93,224714,227586,395072,392200,1239572,1023,605,89,79,1796
1128,2017-07-03,59.265,222939,223354,395692,395277,1237262,1022,604,88,80,1794
1129,2017-07-04,59.4125,226454,232499,405314,399269,1263536,1050,615,90,81,1836
1130,2017-07-05,59.9825,234755,248737,421256,407274,1312022,1034,611,90,84,1819
1131,2017-07-06,60.16,240782,257940,438682,421524,1358928,1032,622,86,85,1825
1132,2017-07-07,60.355,243001,261725,444080,425356,1374162,1011,643,95,87,1836
1133,2017-07-10,60.23,246795,266009,450141,430927,1393872,1031,656,94,89,1870
1134,2017-07-11,60.76,250646,265602,448859,433903,1399010,1011,668,94,87,1860
1135,2017-07-12,60.005,254205,271432,453892,436665,1416194,1070,654,87,87,1898
1136,2017-07-13,59.8225,257341,267462,477923,467802,1470528,1107,668,91,85,1951
1137,2017-07-14,59.09,265805,270740,473428,468493,1478466,1161,654,91,86,1992
1138,2017-07-17,59.3275,272423,273601,477068,475890,1498982,1181,649,93,85,2008
1139,2017-07-18,59.18,272013,274471,479591,477133,1503208,1172,636,91,85,1984
1140,2017-07-19,59.0,276835,283321,485496,479010,1524662,1195,651,98,84,2028
1141,2017-07-20,58.935,147547,196625,429807,380729,1154708,768,388,80,57,1293
1142,2017-07-21,59.36,166166,215556,443506,394116,1219344,866,459,86,67,1478
1143,2017-07-24,60.005,179712,225676,448910,402946,1257244,865,533,89,69,1556
1144,2017-07-25,59.87,189816,233432,453065,409449,1285762,941,552,89,70,1652
1145,2017-07-26,59.3975,201604,241857,479882,439629,1362972,1010,568,93,70,1741
1146,2017-07-27,59.4975,205308,244092,476750,437966,1364116,1044,564,94,68,1770
1147,2017-07-28,59.565,219203,258738,492627,453092,1423660,1081,574,97,68,1820
1148,2017-07-31,59.78,219553,261935,505500,463118,1450106,1102,582,97,69,1850
1149,2017-08-01,60.35,231674,261349,510709,481034,1484766,1122,593,99,70,1884
1150,2017-08-02,60.59,244394,270818,513715,487291,1516218,1082,620,104,70,1876
1151,2017-08-03,60.36,253295,277936,516125,491484,1538840,1120,625,105,68,1918
1152,2017-08-04,59.97,258098,281652,514243,490689,1544682,1153,640,96,70,1959
1153,2017-08-07,60.0325,261558,284579,518881,495860,1560878,1179,648,99,71,1997
1154,2017-08-08,59.8175,260879,299026,537715,499568,1597188,1196,652,96,72,2016
1155,2017-08-09,59.9825,269210,310522,541254,499942,1620928,1192,655,97,72,2016
1156,2017-08-10,60.11,272814,311252,540622,502184,1626872,1216,660,96,72,2044
1157,2017-08-11,59.8625,280672,326327,548106,502451,1657556,1204,672,97,76,2049
1158,2017-08-14,59.87,299500,326725,547425,520200,1693850,1224,663,100,75,2062
1159,2017-08-15,59.7125,299375,332748,553170,519797,1705090,1238,676,99,85,2098
1160,2017-08-16,59.3775,324416,343455,549961,530922,1748754,1264,663,99,88,2114
1161,2017-08-17,59.225,225049,237545,404714,392218,1259526,941,481,89,76,1587
1162,2017-08-18,59.0,237192,256948,429091,409335,1332566,1007,544,90,81,1722
1163,2017-08-21,59.145,240711,269808,451751,422654,1384924,1068,583,93,83,1827
1164,2017-08-22,59.07,244480,274224,441623,411879,1372206,1105,598,96,84,1883
1165,2017-08-23,59.065,243935,280660,447827,411102,1383524,1137,613,99,86,1935
1166,2017-08-24,59.1575,267472,300286,453163,420349,1441270,1157,638,98,87,1980
1167,2017-08-25,58.575,277544,305339,459702,431907,1474492,1196,646,101,89,2032
1168,2017-08-28,58.435,291143,310657,466924,447410,1516134,1226,648,101,90,2065
1169,2017-08-29,58.835,296257,318978,469864,447143,1532242,1224,657,102,89,2072
1170,2017-08-30,58.56,303725,330901,505653,478477,1618756,1258,662,103,90,2113
1171,2017-08-31,58.02,307145,334950,506395,478590,1627080,1271,660,104,90,2125
1172,2017-09-01,57.52,318476,343352,506093,481217,1649138,1331,656,105,88,2180
1173,2017-09-04,57.8475,319739,350575,510766,479930,1661010,1351,663,103,89,2206
1174,2017-09-05,57.52,325101,355283,517360,487178,1684922,1398,653,104,89,2244
1175,2017-09-06,57.35,330665,368254,541526,503937,1744382,1390,661,104,88,2243
1176,2017-09-07,56.9,335615,371125,551323,515813,1773876,1427,659,103,87,2276
1177,2017-09-08,57.3675,338756,370072,551155,519839,1779822,1433,666,105,88,2292
1178,2017-09-11,57.22,341669,368890,553278,526057,1789894,1454,668,104,87,2313
1179,2017-09-12,57.71,351393,387228,579811,543976,1862408,1460,682,104,89,2335
1180,2017-09-13,57.96,363691,390556,584242,557377,1895866,1472,689,104,90,2355
1181,2017-09-14,57.5,375341,399792,604333,579882,1959348,1510,693,105,90,2398
1182,2017-09-15,57.69,377738,411628,618697,584807,1992870,1486,703,106,88,2383
1183,2017-09-18,58.11,380890,411973,620053,588970,2001886,1461,708,106,90,2365
1184,2017-09-19,58.1275,384256,420000,623914,588170,2016340,1451,704,107,90,2352
1185,2017-09-20,58.1225,396297,422345,626212,600164,2045018,1496,701,109,90,2396
1186,2017-09-21,57.9,107455,132491,122183,97147,459276,727,372,62,50,1211
1187,2017-09-22,57.5,124529,150955,133375,106949,515808,840,443,66,55,1404
1188,2017-09-25,57.555,134109,163842,138621,108888,545460,870,468,70,59,1467
1189,2017-09-26,57.82,140683,167031,143593,117245,568552,913,492,69,59,1533
1190,2017-09-27,58.195,149424,171484,146743,124683,592334,946,537,73,60,1616
1191,2017-09-28,57.91,151708,178955,150649,123402,604714,929,505,70,59,1563
1192,2017-09-29,57.48,172899,194619,172532,150812,690862,1017,527,72,60,1676
1193,2017-10-02,57.9125,182487,202122,185622,165987,736218,1031,555,72,60,1718
1194,2017-10-03,57.9,187846,208164,198740,178422,773172,1050,572,75,61,1758
1195,2017-10-04,57.6875,205477,220244,212076,197309,835106,1091,561,76,60,1788
1196,2017-10-05,57.6975,192406,215238,222978,200146,830768,1035,513,72,58,1678
1197,2017-10-06,58.19,204039,230423,251459,225075,910996,1020,580,76,60,1736
1198,2017-10-09,58.33,211837,243872,266565,234530,956804,1036,633,74,61,1804
1199,2017-10-10,57.9875,219677,263797,290546,246426,1020446,1109,628,75,62,1874
1200,2017-10-11,57.8375,228759,272298,299676,256137,1056870,1132,624,78,62,1896
1201,2017-10-12,57.6975,220199,260720,300711,260190,1041820,1095,575,77,57,1804
1202,2017-10-13,57.16,239036,271106,300431,268361,1078934,1209,574,81,61,1925
1203,2017-10-16,57.3175,244661,283363,317010,278308,1123342,1216,591,81,66,1954
1204,2017-10-17,57.2925,245212,284346,322876,283742,1136176,1206,618,84,69,1977
1205,2017-10-18,57.425,247708,287818,325145,285035,1145706,1201,632,83,69,1985
1206,2017-10-19,57.2725,147912,205278,182636,125270,661096,820,440,68,57,1385
1207,2017-10-20,57.4825,165451,218656,194159,140954,719220,895,518,70,60,1543
1208,2017-10-23,57.55,173617,230197,218452,161872,784138,946,551,69,60,1626
1209,2017-10-24,57.62,189813,238047,248834,200600,877294,971,575,73,61,1680
1210,2017-10-25,57.745,192503,243549,264079,213033,913164,984,587,73,61,1705
1211,2017-10-26,57.855,182003,241223,284658,225438,933322,929,549,70,62,1610
1212,2017-10-27,58.06,192525,259719,304666,237472,994382,896,661,72,64,1693
1213,2017-10-30,57.9725,198670,270220,306206,234656,1009752,979,668,74,64,1785
1214,2017-10-31,58.32,203548,271055,311981,244474,1031058,931,687,77,67,1762
1215,2017-11-01,58.29,210783,279983,324599,255399,1070764,993,681,80,70,1824
1216,2017-11-02,58.1625,210106,274403,325837,261540,1071886,953,616,78,65,1712
1217,2017-11-03,59.08,212724,277768,335575,270531,1096598,937,681,79,70,1767
1218,2017-11-07,59.365,220161,277288,342149,285022,1124620,943,687,81,69,1780
1219,2017-11-08,59.2275,233998,288550,343250,288698,1154496,996,697,80,68,1841
1220,2017-11-09,59.29,226069,277372,354889,303586,1161916,972,651,80,67,1770
1221,2017-11-10,59.22,233674,284120,362417,311971,1192182,1042,656,85,68,1851
1222,2017-11-13,59.35,238673,285947,360941,313667,1199228,1043,682,84,70,1879
1223,2017-11-14,60.2375,237147,282622,357715,312240,1189724,992,689,86,69,1836
1224,2017-11-15,60.215,251124,290443,354761,315442,1211770,996,713,85,72,1866
1225,2017-11-16,59.6775,182970,206559,225627,202038,817194,866,506,74,60,1506
1226,2017-11-17,59.08,191520,219659,241639,213500,866318,994,577,79,63,1713
1227,2017-11-20,59.345,202617,233798,255805,224624,916844,1052,619,79,63,1813
1228,2017-11-21,59.1775,217536,241790,270968,246714,977008,1088,645,80,65,1878
1229,2017-11-22,58.485,233803,256053,274823,252573,1017252,1190,637,80,66,1973
1230,2017-11-23,58.45,225693,264260,282329,243762,1016044,1118,602,80,68,1868
1231,2017-11-24,58.37,231846,278070,288949,242725,1041590,1181,639,82,70,1972
1232,2017-11-27,58.4975,239775,284538,302434,257671,1084418,1233,647,83,70,2033
1233,2017-11-28,58.36,249547,306463,324425,267509,1147944,1277,667,84,71,2099
1234,2017-11-29,58.62,255241,318995,357133,293379,1224748,1299,688,90,74,2151
1235,2017-11-30,58.45,262189,319820,348785,291154,1221948,1242,651,87,72,2052
1236,2017-12-01,58.88,265624,327512,365866,303978,1262980,1259,683,85,73,2100
1237,2017-12-04,58.8075,280492,318252,366459,328699,1293902,1263,686,90,75,2114
1238,2017-12-05,58.75,291037,325600,366735,332172,1315544,1314,703,90,75,2182
1239,2017-12-06,59.23,290206,325160,373750,338796,1327912,1299,713,92,75,2179
1240,2017-12-07,59.1775,285238,325976,379966,339228,1330408,1219,667,92,76,2054
1241,2017-12-08,59.13,284354,331381,387664,340637,1344036,1248,705,93,74,2120
1242,2017-12-11,59.005,287400,332511,400558,355447,1375916,1254,709,91,74,2128
1243,2017-12-12,59.285,288061,332803,411061,366319,1398244,1241,690,91,73,2095
1244,2017-12-13,58.6125,292831,336619,415353,371565,1416368,1295,697,90,73,2155
1245,2017-12-14,58.76,293499,347362,430948,377085,1448894,1222,652,91,75,2040
1246,2017-12-15,58.8,297812,356766,441710,382756,1479044,1221,684,91,73,2069
1247,2017-12-18,58.6625,295281,361033,462299,396547,1515160,1213,672,87,76,2048
1248,2017-12-19,58.7625,293195,368713,471971,396453,1530332,1205,646,87,75,2013
1249,2017-12-20,58.71,301590,403401,508581,406770,1620342,1195,647,85,75,2002
1250,2017-12-21,58.4625,70223,166054,226611,130780,593668,497,272,42,45,856
1251,2017-12-22,58.375,82946,192515,248071,138502,662034,576,329,44,45,994
1252,2017-12-25,57.9625,93128,215579,272833,150382,731922,668,362,46,48,1124
1253,2017-12-26,57.62,101736,233336,288945,157345,781362,738,379,46,48,1211
1254,2017-12-27,57.745,111169,263322,329677,177524,881692,783,401,49,49,1282
1255,2017-12-28,57.5025,101224,275566,356325,181983,915098,740,355,51,50,1196
1256,2017-12-29,57.63,105644,296149,375290,184785,961868,786,410,50,50,1296
1257,2018-01-03,57.22,106744,307299,389314,188759,992116,802,423,51,51,1327
1258,2018-01-04,56.84,115027,318313,400260,196974,1030574,848,426,52,52,1378
1259,2018-01-05,56.9825,123264,331666,411043,202641,1068614,871,434,53,52,1410
1260,2018-01-09,56.995,129518,343060,424814,211272,1108664,899,460,56,52,1467
1261,2018-01-10,57.0325,138798,350079,424729,213448,1127054,950,471,56,53,1530
1262,2018-01-11,56.4275,135108,345255,423399,213252,1117014,930,452,56,55,1493
1263,2018-01-12,56.65,145445,361113,440571,224903,1172032,987,477,64,56,1584
1264,2018-01-15,56.32,156142,367565,441414,229991,1195112,1019,471,64,56,1610
1265,2018-01-16,56.53,164457,375625,442335,231167,1213584,1058,487,65,55,1665
1266,2018-01-17,56.7525,173276,381821,444016,235471,1234584,1030,489,66,55,1640
1267,2018-01-18,56.525,97020,108973,128853,116900,451746,722,333,53,47,1155
1268,2018-01-19,56.72,110062,122241,131431,119252,482986,837,404,55,47,1343
1269,2018-01-22,56.495,117393,139278,150734,128849,536254,880,431,56,48,1415
1270,2018-01-23,56.35,140594,152451,167627,155770,616442,914,442,60,50,1466
1271,2018-01-24,56.1725,155167,160462,169907,164612,650148,951,453,61,51,1516
1272,2018-01-25,55.9275,151534,185990,205055,170599,713178,915,410,57,51,1433
1273,2018-01-26,56.275,164981,197000,206626,174607,743214,984,479,58,52,1573
1274,2018-01-29,56.32,181214,215955,244019,209278,850466,1004,514,57,52,1627
1275,2018-01-30,56.385,196958,226506,253608,224060,901132,1046,527,59,54,1686
1276,2018-01-31,56.2075,199245,228889,254898,225254,908286,1066,543,59,55,1723
1277,2018-02-01,55.92,191566,223162,255715,224119,894562,1017,494,60,55,1626
1278,2018-02-02,56.55,197728,232825,266371,231274,928198,1031,538,63,57,1689
1279,2018-02-05,57.195,203614,238344,275868,241138,958964,1031,576,62,56,1725
1280,2018-02-06,56.855,203224,229940,286324,259608,979096,1006,584,63,57,1710
1281,2018-02-07,57.61,212580,239546,291346,264380,1007852,1039,598,64,56,1757
1282,2018-02-08,58.4225,210482,224363,293876,279995,1008716,908,545,65,56,1574
1283,2018-02-09,58.4,208962,228088,296180,277054,1010284,908,577,64,57,1606
1284,2018-02-12,57.83,214770,231585,299598,282783,1028736,960,584,66,57,1667
1285,2018-02-13,57.63,236000,255413,315730,296317,1103460,1005,589,66,57,1717
1286,2018-02-14,56.71,255067,261057,333325,327335,1176784,1043,594,66,57,1760
1287,2018-02-15,56.3925,188157,196991,259694,250860,895702,974,422,62,52,1510
1288,2018-02-16,56.3975,213360,214993,295557,293924,1017834,1116,468,64,53,1701
1289,2018-02-19,56.46,221759,218941,307235,310053,1057988,1173,493,66,55,1787
1290,2018-02-20,56.565,238409,225264,319745,332890,1116308,1200,518,67,57,1842
1291,2018-02-21,56.76,240395,225432,321005,335968,1122800,1206,516,67,57,1846
1292,2018-02-22,56.5175,223932,220255,315349,319026,1078562,1101,478,65,56,1700
1293,2018-02-26,55.705,239907,227131,315686,328462,1111186,1215,482,69,56,1822
1294,2018-02-27,56.275,257836,231554,322649,348931,1160970,1296,526,68,55,1945
1295,2018-02-28,56.3325,259721,232582,328220,355359,1175882,1327,537,68,55,1987
1296,2018-03-01,56.8225,250404,230277,330579,350706,1161966,1181,533,69,55,1838
1297,2018-03-02,56.815,254403,231027,347625,371001,1204056,1151,560,71,55,1837
1298,2018-03-05,56.42,259839,235296,366329,390872,1252336,1175,572,71,55,1873
1299,2018-03-06,56.67,282560,245485,369459,406534,1304038,1263,557,71,54,1945
1300,2018-03-07,56.79,270183,242619,378778,406342,1297922,1179,539,71,56,1845
1301,2018-03-09,56.66,271481,240885,382810,413406,1308582,1202,555,73,57,1887
1302,2018-03-12,56.88,283314,246536,415060,451838,1396748,1203,568,72,57,1900
1303,2018-03-13,57.02,294402,254437,423134,463099,1435072,1202,557,72,57,1888
1304,2018-03-14,57.1225,309177,256426,430482,483233,1479318,1154,558,72,61,1845
1305,2018-03-15,57.46,87094,73231,83302,97165,340792,573,304,39,37,953
1306,2018-03-16,57.49,100371,100283,104777,104865,410296,660,383,44,38,1125
1307,2018-03-19,57.84,116954,115686,115016,116284,463940,701,421,43,41,1206
1308,2018-03-20,57.53,137726,133771,129023,132978,533498,762,441,44,40,1287
1309,2018-03-21,56.88,159904,152275,135231,142860,590270,810,449,45,40,1344
1310,2018-03-22,57.245,127900,150142,141081,118839,537962,733,405,44,39,1221
1311,2018-03-23,57.29,134996,157842,163061,140215,596114,802,435,48,40,1325
1312,2018-03-26,57.1625,142701,166902,168166,143965,621734,811,474,47,42,1374
1313,2018-03-27,57.5125,161240,161440,143763,143563,610006,859,481,48,42,1430
1314,2018-03-28,57.7225,165366,165068,155941,156239,642614,845,500,49,42,1436
1315,2018-03-29,57.2575,153650,163499,153257,143408,613814,781,445,47,43,1316
1316,2018-03-30,57.145,159077,173223,165039,150893,648232,863,485,48,43,1439
1317,2018-04-02,57.4825,162016,175266,173289,160039,670610,867,490,49,44,1450
1318,2018-04-03,57.57,167671,176619,179837,170889,695016,869,508,52,44,1473
1319,2018-04-04,57.445,182184,178015,184097,188266,732562,880,518,51,44,1493
1320,2018-04-05,57.71,168750,171981,180101,176870,697702,828,482,50,44,1404
1321,2018-04-06,58.175,181085,184536,189782,186331,741734,858,536,50,44,1488
1322,2018-04-09,60.66,221345,177387,216067,260025,874824,725,537,49,46,1357
1323,2018-04-10,63.0225,225184,183867,217837,259154,886042,740,542,51,46,1379
1324,2018-04-11,62.59,246715,190490,221928,278153,937286,808,550,51,47,1456
1325,2018-04-12,61.99,231139,192853,218203,256489,898684,851,486,50,46,1433
1326,2018-04-13,62.05,241818,198686,217375,260507,918386,963,521,50,49,1583
1327,2018-04-16,61.165,249754,204833,219829,264750,939166,1002,535,49,50,1636
1328,2018-04-17,61.5575,252922,209306,219939,263555,945722,986,529,50,49,1614
1329,2018-04-18,60.85,255906,209491,216025,262440,943862,1005,542,50,49,1646
1330,2018-04-19,60.8925,130818,91404,104166,143580,469968,705,326,41,41,1113
1331,2018-04-20,61.4,140587,100309,105749,146027,492672,801,410,43,42,1296
1332,2018-04-23,61.805,160118,110534,109084,158668,538404,851,424,46,43,1364
1333,2018-04-24,61.62,164509,112053,115527,167983,560072,892,426,46,42,1406
1334,2018-04-25,62.365,173437,121025,123899,176311,594672,869,460,48,42,1419
1335,2018-04-26,62.72,152997,110697,123359,165659,552712,800,406,50,42,1298
1336,2018-04-27,62.155,159314,117500,126951,168765,572530,876,429,50,45,1400
1337,2018-04-28,62.27,166063,124011,128390,170442,588906,885,444,50,45,1424
1338,2018-04-30,62.9675,171241,124187,126641,173695,595764,892,461,50,46,1449
1339,2018-05-02,64.02,191589,124259,123478,190808,630134,858,461,50,47,1416
1340,2018-05-03,63.025,170762,123840,121945,168867,585414,831,419,49,43,1342
1341,2018-05-04,62.505,181024,131727,124771,174068,611590,886,458,49,46,1439
1342,2018-05-07,62.9325,192941,142007,131419,182353,648720,928,466,50,47,1491
1343,2018-05-08,63.225,199973,147292,139555,192236,679056,921,481,51,48,1501
1344,2018-05-10,61.71,198315,147700,147249,197864,691128,929,427,50,46,1452
1345,2018-05-11,61.93,225466,142560,136604,219510,724140,1009,452,49,46,1556
1346,2018-05-14,61.85,242579,145370,137928,235137,761014,1025,457,50,48,1580
1347,2018-05-15,62.3175,233374,141336,139454,231492,745656,945,469,50,48,1512
1348,2018-05-16,61.73,236235,142492,138097,231840,748664,999,479,50,48,1576
1349,2018-05-17,62.185,150395,108617,115509,157287,531808,770,369,45,48,1232
1350,2018-05-18,62.2575,167448,115729,114542,166261,563980,809,451,48,50,1358
1351,2018-05-21,61.6,178065,123073,118394,173386,592918,870,458,50,51,1429
1352,2018-05-22,61.21,205467,136360,132908,202015,676750,972,459,50,50,1531
1353,2018-05-23,61.33,216556,145088,142794,214262,718700,984,479,52,54,1569
1354,2018-05-24,61.6,174918,129463,148403,193858,646642,885,404,52,51,1392
1355,2018-05-25,62.2875,177946,134858,153067,196155,662026,903,446,53,50,1452
1356,2018-05-28,62.32,179281,134999,149186,193468,656934,933,467,53,50,1503
1357,2018-05-29,62.815,188705,139382,149424,198747,676258,894,482,52,50,1478
1358,2018-05-30,62.075,190567,146161,158707,203113,698548,930,497,54,52,1533
1359,2018-05-31,62.405,175870,136858,158799,197811,669338,899,438,52,48,1437
1360,2018-06-01,62.1925,191051,142276,159638,208413,701378,975,481,56,52,1564
1361,2018-06-04,62.0575,208737,143755,165507,230489,748488,998,491,56,52,1597
1362,2018-06-05,62.15,212736,145793,171592,238535,768656,984,507,56,51,1598
1363,2018-06-06,61.7675,227501,149531,177872,255842,810746,1018,509,56,52,1635
1364,2018-06-07,62.4175,193035,143479,172243,221799,730556,914,469,56,52,1491
1365,2018-06-08,62.31,194794,149843,178777,223728,747142,930,511,54,52,1547
1366,2018-06-09,62.525,196537,152782,180477,224232,754028,919,521,55,51,1546
1367,2018-06-11,62.8175,197840,154868,182199,225171,760078,925,535,54,51,1565
1368,2018-06-13,62.535,220965,174940,185056,231081,812042,988,549,55,52,1644
1369,2018-06-14,62.63,218438,169308,180606,229736,798088,974,480,54,51,1559
1370,2018-06-15,63.1975,213081,170238,183086,225929,792334,887,556,55,54,1552
1371,2018-06-18,63.4525,238536,164684,177546,251398,832164,891,556,57,57,1561
1372,2018-06-19,63.875,250759,169889,181554,262424,864626,870,557,60,59,1546
1373,2018-06-20,63.69,264961,167500,179660,277121,889242,881,548,59,58,1546
1374,2018-06-21,63.715,43253,41133,47639,49759,181784,438,251,38,43,770
1375,2018-06-22,62.895,60587,58557,59302,61332,239778,533,298,43,43,917
1376,2018-06-25,62.7825,72054,66897,62068,67225,268244,629,320,45,44,1038
1377,2018-06-26,63.0275,82191,69666,64087,76612,292556,641,349,47,48,1085
1378,2018-06-27,63.23,94643,72299,74887,97231,339060,673,370,49,50,1142
1379,2018-06-28,62.8,61376,61898,70522,70000,263796,587,326,45,49,1007
1380,2018-06-29,62.77,68374,72386,78289,74277,293326,659,372,46,47,1124
1381,2018-07-02,63.43,76122,75345,81777,82554,315798,649,405,45,47,1146
1382,2018-07-03,63.145,81008,80346,85575,86237,333166,682,414,44,48,1188
1383,2018-07-04,63.24,87820,86856,87226,88190,350092,708,430,44,49,1231
1384,2018-07-05,63.115,81316,80267,81449,82498,325530,637,356,45,48,1086
1385,2018-07-06,62.9725,93224,92688,91896,92432,370240,694,389,48,51,1182
1386,2018-07-09,62.485,100970,102303,108196,106863,418332,753,392,48,48,1241
1387,2018-07-10,61.735,121040,118458,113079,115661,468238,820,407,49,49,1325
1388,2018-07-11,62.3575,144034,130532,120591,134093,529250,863,414,49,50,1376
1389,2018-07-12,62.255,134018,117619,109800,126199,487636,799,382,45,48,1274
1390,2018-07-13,62.56,148743,127883,117275,138135,532036,813,418,48,48,1327
1391,2018-07-16,62.33,152094,112776,107690,147008,519568,842,439,53,48,1382
1392,2018-07-17,62.6,157080,114468,108436,151048,531032,854,435,52,48,1389
1393,2018-07-18,62.9625,162816,113215,110037,159638,545706,777,456,54,47,1334
1394,2018-07-19,63.6625,87591,45898,45233,86926,265648,551,321,39,34,945
1395,2018-07-20,63.515,105097,55192,48726,98631,307646,632,382,40,36,1090
1396,2018-07-23,63.0675,110582,60425,49634,99791,320432,703,405,43,37,1188
1397,2018-07-24,63.325,119509,67960,48659,100208,336336,762,426,43,39,1270
1398,2018-07-25,62.82,121565,74184,55291,102672,353712,799,436,43,41,1319
1399,2018-07-26,62.955,109864,67839,52799,94824,325326,700,371,39,37,1147
1400,2018-07-27,62.7975,115945,75017,54329,95257,340548,784,429,42,39,1294
1401,2018-07-30,62.2375,138794,86737,54335,106392,386258,874,438,43,38,1393
1402,2018-07-31,62.5025,147452,89189,56918,115181,408740,908,449,46,39,1442
1403,2018-08-01,63.045,155725,87737,58279,126267,428008,900,465,45,40,1450
1404,2018-08-02,63.405,145928,94180,74499,126247,440854,781,436,44,37,1298
1405,2018-08-03,63.3375,156035,101957,80350,134428,472770,851,481,44,39,1415
1406,2018-08-06,63.74,161895,109083,100490,153302,524770,865,510,45,39,1459
1407,2018-08-07,63.49,188114,121300,106838,173652,589904,900,513,46,39,1498
1408,2018-08-08,65.5475,215007,131827,112656,195836,655326,841,532,51,39,1463
1409,2018-08-09,66.65,221895,132078,120176,209993,684142,768,482,48,43,1341
1410,2018-08-10,67.72,241389,151229,131627,221787,746032,784,525,49,45,1403
1411,2018-08-13,67.8,253248,161838,151352,242762,809200,846,546,49,47,1488
1412,2018-08-14,66.34,275314,180036,155715,250993,862058,892,545,50,45,1532
1413,2018-08-15,67.29,297774,187941,155657,265490,906862,912,549,51,45,1557
1414,2018-08-16,66.8425,147408,99468,85649,133589,466114,712,386,44,33,1175
1415,2018-08-17,67.03,155660,109234,90111,136537,491542,785,457,47,37,1326
1416,2018-08-20,67.1075,166419,118164,95299,143554,523436,867,475,49,39,1430
1417,2018-08-21,67.275,186832,132487,97444,151789,568552,935,490,50,40,1515
1418,2018-08-22,68.03,193104,138789,97736,152051,581680,944,520,53,41,1558
1419,2018-08-23,68.19,174036,130398,87551,131189,523174,783,471,50,40,1344
1420,2018-08-24,67.1,181770,147042,100243,134971,564026,879,517,51,46,1493
1421,2018-08-27,67.52,183708,160396,113293,136605,594002,929,527,52,47,1555
1422,2018-08-28,67.87,197204,166975,119042,149271,632492,950,544,53,49,1596
1423,2018-08-29,67.94,208175,170042,120102,158235,656554,919,549,52,51,1571
1424,2018-08-30,68.2375,185164,163868,120994,142290,612316,816,461,49,44,1370
1425,2018-08-31,67.55,200657,173274,122432,149815,646178,907,514,51,48,1520
1426,2018-09-03,68.12,203978,175543,123994,152429,655944,911,552,51,49,1563
1427,2018-09-04,68.11,215175,183587,145389,176977,721128,933,550,53,50,1586
1428,2018-09-05,68.25,226687,186411,149523,189799,752420,972,562,55,51,1640
1429,2018-09-06,69.255,198994,182418,138550,155126,675088,864,497,53,47,1461
1430,2018-09-07,69.9125,219338,192483,144806,171661,728288,902,554,55,49,1560
1431,2018-09-10,70.565,236453,200050,150178,186581,773262,895,574,56,50,1575
1432,2018-09-11,69.41,257123,207870,148541,197794,811328,950,577,57,52,1636
1433,2018-09-12,69.0325,288769,230325,176113,234557,929764,1028,558,59,48,1693
1434,2018-09-13,68.25,242369,203958,183052,221463,850842,958,471,57,45,1531
1435,2018-09-14,68.0525,261499,221796,187889,227592,898776,1087,527,57,47,1718
1436,2018-09-17,68.0625,268637,222304,186414,232747,910102,1111,535,57,47,1750
1437,2018-09-18,67.3725,281533,233937,187962,235558,938990,1150,536,57,45,1788
1438,2018-09-19,66.83,305275,243471,190607,252411,991764,1194,546,60,49,1849
1439,2018-09-20,66.26,60411,64028,69636,66019,260094,684,306,35,29,1054
1440,2018-09-21,66.41,77286,76183,73759,74862,302090,820,382,39,29,1270
1441,2018-09-24,65.835,94590,85891,78900,87599,346980,968,397,41,33,1439
1442,2018-09-25,65.8925,119157,98984,87324,107497,412962,1092,417,42,32,1583
1443,2018-09-26,65.8,128490,102927,93257,118820,443494,1204,440,44,31,1719
1444,2018-09-27,65.6225,95277,87125,80443,88595,351440,1004,371,43,32,1450
1445,2018-09-28,65.535,109625,98215,81556,92966,382362,1107,433,44,32,1616
1446,2018-10-01,65.0,112362,101031,81490,92821,387704,1148,450,44,32,1674
1447,2018-10-02,65.5,124838,111845,85979,98972,421634,1196,478,46,33,1753
1448,2018-10-03,65.8625,134267,112211,88815,110871,446164,1261,486,46,32,1825
1449,2018-10-04,67.0175,110269,104464,91869,97674,404276,1050,423,46,31,1550
1450,2018-10-05,66.5975,123288,111880,94918,106326,436412,1132,486,46,34,1698
1451,2018-10-08,66.5575,128936,113662,94245,109519,446362,1143,509,46,36,1734
1452,2018-10-09,66.25,131469,116149,94666,109986,452270,1155,514,47,37,1753
1453,2018-10-10,66.9,153786,123441,98748,129093,505068,1194,524,50,36,1804
1454,2018-10-11,66.27,122321,109915,92366,104772,429374,1128,452,44,35,1659
1455,2018-10-12,66.1175,133491,111185,87604,109910,442190,1199,497,45,37,1778
1456,2018-10-15,65.65,154357,117981,84241,120617,477196,1265,493,44,37,1839
1457,2018-10-16,65.3075,166455,118033,85559,133981,504028,1281,491,46,37,1855
1458,2018-10-17,65.4975,196664,144971,113497,165190,620322,1310,496,50,36,1892
1459,2018-10-18,65.82,115338,93974,93488,114852,417652,847,344,40,32,1263
1460,2018-10-19,65.49,131286,101107,98792,128971,460156,959,425,43,34,1461
1461,2018-10-22,65.25,157977,113778,101777,145976,519508,1030,443,44,36,1553
1462,2018-10-23,65.5125,168515,121179,107307,154643,551644,1076,468,46,36,1626
1463,2018-10-24,65.685,188871,130732,109054,167193,595850,1094,486,46,37,1663
1464,2018-10-25,65.5925,157241,125881,116505,147865,547492,976,420,45,37,1478
1465,2018-10-26,65.72,173741,138762,120673,155652,588828,1043,492,48,39,1622
1466,2018-10-29,65.85,179047,140314,119300,158033,596694,1096,505,49,40,1690
1467,2018-10-30,65.56,183532,143051,120643,161124,608350,1137,520,52,41,1750
1468,2018-10-31,65.875,192341,145496,123392,170237,631466,1141,528,54,44,1767
1469,2018-11-01,65.72,179341,139863,122025,161503,602732,1076,485,49,43,1653
1470,2018-11-02,66.2025,187624,150256,124910,162278,625068,1135,556,52,46,1789
1471,2018-11-06,66.11,197703,156242,134091,175552,663588,1185,590,53,44,1872
1472,2018-11-07,66.32,207488,155625,133418,185281,681812,1211,593,53,44,1901
1473,2018-11-08,66.9025,183510,153260,135743,165993,638506,1124,546,51,38,1759
1474,2018-11-09,68.005,192394,152698,139797,179493,664382,1072,610,53,42,1777
1475,2018-11-12,67.845,208662,164868,147918,191712,713160,1085,630,57,46,1818
1476,2018-11-13,68.13,219518,169319,146625,196824,732286,1124,640,56,48,1868
1477,2018-11-14,67.02,246681,178040,146192,214833,785746,1155,642,60,48,1905
1478,2018-11-15,65.8975,168712,137054,115925,147583,569274,926,436,51,36,1449
1479,2018-11-16,65.98,179960,155324,130183,154819,620286,1042,508,54,39,1643
1480,2018-11-19,65.55,184642,164805,135465,155302,640214,1081,539,55,42,1717
1481,2018-11-20,66.165,187791,169295,143170,161666,661922,1145,570,55,47,1817
1482,2018-11-21,65.66,195102,175467,148300,167935,686804,1198,582,59,50,1889
1483,2018-11-22,65.62,182313,164582,149011,166742,662648,1049,490,54,42,1635
1484,2018-11-23,66.1925,192056,176603,155101,170554,694314,1096,567,55,46,1764
1485,2018-11-26,67.1025,212508,181980,162986,193514,750988,1161,630,56,45,1892
1486,2018-11-27,67.1075,209346,190296,176228,195278,771148,1157,642,57,48,1904
1487,2018-11-28,66.955,215316,190592,174583,199307,779798,1130,655,56,48,1889
1488,2018-11-29,66.21,188966,180689,174785,183062,727502,1034,530,55,45,1664
1489,2018-11-30,66.95,200383,187197,179560,192746,759886,1069,621,56,48,1794
1490,2018-12-03,66.5275,203963,189226,182042,196779,772010,1107,634,56,48,1845
1491,2018-12-04,66.82,212765,204419,197961,206307,821452,1126,647,56,49,1878
1492,2018-12-05,66.57,241870,226550,217309,232629,918358,1167,666,57,50,1940
1493,2018-12-06,66.8675,233001,221407,221454,233048,908910,1072,572,57,46,1747
1494,2018-12-07,66.395,241850,227944,222247,236153,928194,1134,637,57,48,1876
1495,2018-12-10,66.6425,248173,243025,232175,237323,960696,1150,641,60,49,1900
1496,2018-12-11,66.3525,256996,252730,235398,239664,984788,1157,642,59,49,1907
1497,2018-12-12,66.3825,266346,255580,252947,263713,1038586,1176,647,62,48,1933
1498,2018-12-13,66.235,254489,252134,261200,263555,1031378,1085,549,58,44,1736
1499,2018-12-14,66.76,261988,258047,273256,277197,1070488,1118,616,60,47,1841
1500,2018-12-14,66.76,261988,258047,273256,277197,1070488,1118,616,60,47,1841
1501,2018-12-17,66.78,268307,265847,270349,272809,1077312,1128,622,57,47,1854
1502,2018-12-18,67.2825,289620,269570,256598,276648,1092436,1132,639,58,47,1876
1503,2018-12-19,67.46,283624,282857,266683,267450,1100614,1081,631,57,46,1815
1504,2018-12-20,68.2925,96589,139013,151433,109009,496044,515,345,40,31,931
1505,2018-12-21,68.84,108296,159651,190287,138932,597166,583,406,44,37,1070
1506,2018-12-24,68.5825,123038,188336,208891,143593,663858,677,466,45,39,1227
1507,2018-12-25,68.665,127719,195696,215091,147114,685620,703,481,45,42,1271
1508,2018-12-26,68.695,135088,215259,232847,152676,735870,717,502,46,42,1307
1509,2018-12-27,69.56,116388,217628,256867,155627,746510,629,369,49,41,1088
1510,2018-12-28,69.5175,121630,240004,282298,163924,807856,667,425,48,42,1182
1511,2018-12-29,69.8175,123477,256136,299695,167036,846344,684,446,48,41,1219
1512,2019-01-03,68.64,133392,268879,320068,184581,906920,722,479,48,41,1290
1513,2019-01-04,67.74,137208,275415,322607,184400,919630,787,485,49,39,1360
1514,2019-01-08,66.885,154213,296188,340381,198406,989188,892,482,48,41,1463
1515,2019-01-09,66.745,163555,301045,338489,200999,1004088,968,500,50,41,1559
1516,2019-01-10,66.91,151657,273635,316817,194839,936948,893,427,49,39,1408
1517,2019-01-11,66.875,163312,286171,318870,196011,964364,962,472,49,41,1524
1518,2019-01-14,67.075,167627,292553,318054,193128,971362,1019,517,51,41,1628
1519,2019-01-15,66.96,165127,295602,318254,187779,966762,1052,550,51,41,1694
1520,2019-01-16,66.3675,178969,305379,330329,203919,1018596,1089,540,51,42,1722
1521,2019-01-17,66.37,97059,103339,124189,117909,442496,736,376,37,37,1186
1522,2019-01-18,66.275,117799,124251,141361,134909,518320,826,457,40,40,1363
1523,2019-01-21,66.39,129572,134293,141098,136377,541340,882,498,41,42,1463
1524,2019-01-22,66.535,131268,137883,141691,135076,545918,921,528,42,42,1533
1525,2019-01-23,66.0725,132426,141001,143132,134557,551116,947,542,42,41,1572
1526,2019-01-24,65.7775,125278,135051,150369,140596,551294,884,474,42,39,1439
1527,2019-01-25,66.0,158843,164364,161252,155731,640190,950,546,46,42,1584
1528,2019-01-28,66.26,162133,171407,169137,159863,662540,1002,579,46,42,1669
1529,2019-01-29,66.05,166438,179562,174092,160968,681060,1079,608,47,44,1778
1530,2019-01-30,65.505,172513,183909,175519,164123,696064,1101,616,48,44,1809
1531,2019-01-31,65.4,174582,169000,168636,174218,686436,1091,468,45,38,1642
1532,2019-02-01,65.505,188898,183402,172728,178224,723252,1149,545,46,41,1781
1533,2019-02-04,65.59,183940,180253,174276,177963,716432,1184,575,47,42,1848
1534,2019-02-05,65.62,180507,183136,174079,171450,709172,1194,591,47,41,1873
1535,2019-02-06,65.87,198644,204372,177604,171876,752496,1229,620,48,43,1940
1536,2019-02-07,65.9075,170827,181812,172161,161176,685976,1116,530,46,39,1731
1537,2019-02-08,65.81,187147,200549,178548,165146,731390,1184,590,48,41,1863
1538,2019-02-11,65.85,192144,207589,194115,178670,772518,1221,626,48,41,1936
1539,2019-02-12,65.885,201703,221953,210205,189955,823816,1239,633,48,41,1961
1540,2019-02-13,66.515,214243,230741,210611,194113,849708,1243,634,48,44,1969
1541,2019-02-14,66.645,201816,217803,210968,194981,825568,1104,562,47,40,1753
1542,2019-02-15,66.3,204875,230033,213914,188756,837578,1168,621,48,40,1877
1543,2019-02-18,66.28,214440,237403,218351,195388,865582,1236,619,50,42,1947
1544,2019-02-19,65.7625,232766,251747,223763,204782,913058,1260,626,53,43,1982
1545,2019-02-20,65.6325,247702,263083,223214,207833,941832,1280,633,53,45,2011
1546,2019-02-21,65.57,169813,194686,190773,165900,721172,1058,470,41,36,1605
1547,2019-02-22,65.3925,180845,207977,196744,169612,755178,1154,568,44,41,1807
1548,2019-02-25,65.49,195776,210434,198058,183400,787668,1191,596,43,42,1872
1549,2019-02-26,65.7,204001,215168,202095,190928,812192,1225,627,43,44,1939
1550,2019-02-27,65.79,231006,229112,212897,214791,887806,1245,669,44,46,2004
1551,2019-02-28,65.905,207796,208581,201154,200369,817900,1133,558,40,41,1772
1552,2019-03-01,65.94,220450,217645,201746,204551,844392,1192,607,39,43,1881
1553,2019-03-04,65.74,248881,236466,212739,225154,923240,1229,618,40,44,1931
1554,2019-03-05,65.75,296502,257146,226859,266215,1046722,1246,648,43,47,1984
1555,2019-03-06,65.98,313538,268591,233091,278038,1093258,1239,675,44,47,2005
1556,2019-03-07,66.2825,294768,252870,232076,273974,1053688,1146,593,43,44,1826
1557,2019-03-11,65.97,305968,264655,233876,275189,1079688,1184,655,43,44,1926
1558,2019-03-12,65.635,307754,274858,244147,277043,1103802,1213,636,44,45,1938
1559,2019-03-13,65.4,322486,286176,246180,282490,1137332,1292,634,44,46,2016
1560,2019-03-14,65.5125,299124,259500,233374,272998,1064996,1225,568,41,42,1876
1561,2019-03-15,64.815,304782,264720,240106,280168,1089776,1284,606,42,45,1977
1562,2019-03-18,64.365,360840,289577,224871,296134,1171422,1421,632,46,54,2153
1563,2019-03-19,64.39,397661,318100,251426,330987,1298174,1466,650,48,55,2219
1564,2019-03-20,63.8675,430244,352246,272974,350972,1406436,1461,659,49,55,2224
1565,2019-03-21,63.87,260528,157536,147267,250259,815590,834,362,41,41,1278
1566,2019-03-22,64.66,311148,178067,164371,297452,951038,866,477,47,46,1436
1567,2019-03-25,64.085,325668,198634,177627,304661,1006590,983,499,47,48,1577
1568,2019-03-26,64.4,332018,210451,188563,310130,1041162,1025,524,47,50,1646
1569,2019-03-27,64.835,336716,230144,205962,312534,1085356,1006,573,47,51,1677
1570,2019-03-28,64.94,329427,208576,202534,323385,1063922,882,471,44,49,1446
1571,2019-03-29,65.6375,342549,223595,212848,331802,1110794,907,553,46,50,1556
1572,2019-04-01,65.1725,362845,248388,224117,338574,1173924,990,592,46,50,1678
1573,2019-04-02,65.2975,370567,261064,232616,342119,1206366,1015,609,46,50,1720
1574,2019-04-03,65.24,446254,306400,264005,403859,1420518,1069,611,47,52,1779
1575,2019-04-04,65.475,422937,294383,261802,390356,1369478,937,522,47,47,1553
1576,2019-04-05,65.34,434030,301757,267485,399758,1403030,1030,566,46,52,1694
1577,2019-04-08,64.8775,440970,304207,269641,406404,1421222,1081,578,44,51,1754
1578,2019-04-09,64.92,454769,311480,262515,405804,1434568,1129,590,44,50,1813
1579,2019-04-10,64.2925,461889,313210,263785,412464,1451348,1138,587,46,51,1822
1580,2019-04-11,64.61,441810,300064,261041,402787,1405702,1023,533,48,42,1646
1581,2019-04-12,64.35,458031,314487,268238,411782,1452538,1085,565,48,45,1743
1582,2019-04-15,64.26,464726,317342,268373,415757,1466198,1116,572,48,46,1782
1583,2019-04-16,64.09,469113,320465,269999,418647,1478224,1135,593,50,48,1826
1584,2019-04-17,63.845,483526,339344,276836,421018,1520724,1172,590,50,47,1859
1585,2019-04-18,63.8925,323090,256934,218248,284404,1082676,810,398,37,37,1282
1586,2019-04-19,64.05,330922,269532,239699,301089,1141242,880,518,41,42,1481
1587,2019-04-22,63.82,342391,278563,242216,306044,1169214,937,546,42,46,1571
1588,2019-04-23,63.6875,349464,286566,248167,311065,1195262,989,561,43,47,1640
1589,2019-04-24,64.3225,358721,291749,252129,319101,1221700,1003,593,45,50,1691
1590,2019-04-25,64.655,356407,278361,227987,306033,1168788,904,501,39,44,1488
1591,2019-04-26,64.735,372357,300293,244743,316807,1234200,975,550,40,45,1610
1592,2019-04-29,64.4575,379922,302080,235395,313237,1230634,1019,572,40,47,1678
1593,2019-04-30,64.6225,380758,304691,241076,317143,1243668,1033,597,40,47,1717
1594,2019-05-02,65.4375,370497,293575,238409,315331,1217812,889,541,39,44,1513
1595,2019-05-03,65.0775,376205,298492,239924,317637,1232258,932,563,40,44,1579
1596,2019-05-06,65.2275,383648,307543,245755,321860,1258806,985,590,39,44,1658
1597,2019-05-07,65.4075,390178,314181,252234,328231,1284824,997,608,40,46,1691
1598,2019-05-08,65.0725,380459,303265,249889,327083,1260696,962,547,40,41,1590
1599,2019-05-10,65.075,383152,307196,250831,326787,1267966,977,614,41,42,1674
1600,2019-05-13,65.43,389661,313648,250925,326938,1281172,999,633,43,44,1719
1601,2019-05-14,64.97,397254,320102,250171,327323,1294850,1019,635,41,43,1738
1602,2019-05-15,64.65,403398,323293,250093,330198,1306982,1066,617,42,46,1771
1603,2019-05-16,64.65,281801,260546,203946,225201,971494,859,437,34,37,1367
1604,2019-05-17,64.7775,291319,267393,207252,231178,997142,921,523,36,40,1520
1605,2019-05-20,64.525,293214,271596,209320,230938,1005068,970,534,38,40,1582
1606,2019-05-21,64.41,300615,276789,211743,235569,1024716,993,538,38,41,1610
1607,2019-05-22,64.39,307821,283726,212086,236181,1039814,1029,544,39,42,1654
1608,2019-05-23,64.855,305702,279150,209284,235836,1029972,912,489,38,40,1479
1609,2019-05-24,64.4725,320560,272812,210759,258507,1062638,988,531,40,42,1601
1610,2019-05-27,64.4575,324153,282428,220272,261997,1088850,1015,546,42,42,1645
1611,2019-05-28,64.715,323154,281185,220696,262665,1087700,1021,558,41,41,1661
1612,2019-05-29,64.97,328548,281852,226039,272735,1109174,966,582,43,42,1633
1613,2019-05-30,65.17,314404,266154,211634,259884,1052076,912,508,40,39,1499
1614,2019-05-31,65.43,321343,270476,226230,277097,1095146,934,575,43,45,1597
1615,2019-06-03,65.34,330699,274567,229818,285950,1121034,938,584,41,45,1608
1616,2019-06-04,65.165,333337,279932,233573,286978,1133820,969,590,42,45,1646
1617,2019-06-05,65.395,339580,283277,238871,295174,1156902,1006,592,42,47,1687
1618,2019-06-06,65.085,324769,264045,215784,276508,1081106,922,492,40,43,1497
1619,2019-06-07,64.805,331404,271896,223470,282978,1109748,972,536,41,43,1592
1620,2019-06-10,64.78,349939,286803,240913,304049,1181704,1013,560,40,45,1658
1621,2019-06-11,64.5575,356459,294711,245361,307109,1203640,1034,569,40,45,1688
1622,2019-06-13,64.58,353245,291645,245289,306889,1197068,977,510,39,40,1566
1623,2019-06-14,64.38,361431,297565,246096,309962,1215054,1025,545,40,40,1650
1624,2019-06-17,64.32,361120,300311,249045,309854,1220330,1023,559,41,40,1663
1625,2019-06-18,64.02,371832,316409,256708,312131,1257080,1056,565,42,42,1705
1626,2019-06-19,63.785,380026,330850,266209,315385,1292470,1064,567,43,43,1717
1627,2019-06-20,62.89,94187,85133,45230,54284,278834,542,312,25,37,916
1628,2019-06-21,63.025,106630,93170,51289,64749,315838,656,387,29,38,1110
1629,2019-06-24,62.6,128860,107602,54866,76124,367452,770,436,30,40,1276
1630,2019-06-25,62.835,136481,128002,79791,88270,432544,820,474,33,42,1369
1631,2019-06-26,63.0725,148203,139512,80949,89640,458304,872,500,34,43,1449
1632,2019-06-27,63.0725,136590,127704,80217,89103,433614,811,410,33,42,1296
1633,2019-06-28,63.24,144945,133279,83073,94739,456036,879,465,33,43,1420
1634,2019-07-01,62.96,156683,141734,84753,99702,482872,932,497,34,46,1509
1635,2019-07-02,63.32,160210,144737,86390,101863,493200,951,532,36,45,1564
1636,2019-07-03,63.32,168451,148245,88018,108224,512938,981,543,37,46,1607
1637,2019-07-04,63.48,162843,139833,86379,109389,498444,910,466,36,44,1456
1638,2019-07-05,63.8025,167754,144026,88307,112035,512122,929,531,37,46,1543
1639,2019-07-08,63.695,176525,150637,88792,114680,530634,975,550,38,46,1609
1640,2019-07-09,63.915,178307,163378,100968,115897,558550,986,594,37,47,1664
1641,2019-07-10,63.18,185684,167729,101909,119864,575186,1009,590,37,48,1684
1642,2019-07-11,62.815,185624,159257,103425,129792,578098,1028,504,37,45,1614
1643,2019-07-12,62.9775,192929,165387,103033,130575,591924,1072,569,37,47,1725
1644,2019-07-15,62.67,208643,171464,105534,142713,628354,1126,563,37,50,1776
1645,2019-07-16,63.045,211253,173762,107243,144734,636992,1148,583,38,50,1819
1646,2019-07-17,62.935,215543,179793,122882,158632,676850,1161,596,40,51,1848
1647,2019-07-18,62.8075,139004,128923,103033,113114,484074,863,423,32,40,1358
1648,2019-07-19,63.055,153051,138984,113776,127843,533654,945,506,35,45,1531
1649,2019-07-22,63.095,156588,142459,122817,136946,558810,1009,550,34,45,1638
1650,2019-07-23,63.16,164245,150539,125854,139560,580198,1031,585,33,46,1695
1651,2019-07-24,63.2975,168647,154036,127077,141688,591448,1091,598,34,46,1769
1652,2019-07-25,63.2375,166917,150291,116480,133106,566794,1015,493,33,42,1583
1653,2019-07-26,63.3675,178768,159450,120544,139862,598624,1070,559,35,45,1709
1654,2019-07-29,63.4325,187778,167287,123828,144319,623212,1097,592,36,44,1769
1655,2019-07-30,63.5075,193092,171101,122722,144713,631628,1101,628,37,45,1811
1656,2019-07-31,63.625,202477,177320,123195,148352,651344,1144,644,37,51,1876
1657,2019-08-01,64.355,196217,176077,122717,142857,637868,1003,557,39,51,1650
1658,2019-08-02,65.2725,225425,208789,171745,188381,794340,933,635,39,54,1661
1659,2019-08-05,65.53,238677,213964,168577,193290,814508,988,665,40,54,1747
1660,2019-08-06,65.2725,242610,218270,168254,192594,821728,1010,689,41,54,1794
1661,2019-08-07,65.3325,247178,218324,174321,203175,842998,1014,689,44,55,1802
1662,2019-08-08,65.045,242244,213350,168495,197389,821478,961,576,43,50,1630
1663,2019-08-09,65.2825,246428,221451,171053,196030,834962,982,648,44,53,1727
1664,2019-08-12,65.405,274727,221643,153095,206179,855644,1012,667,43,54,1776
1665,2019-08-13,64.93,257909,217140,162634,203403,841086,1032,671,44,54,1801
1666,2019-08-14,66.015,284391,222172,166279,228498,901340,982,699,44,54,1779
1667,2019-08-15,66.0575,240859,181300,121146,180705,724010,831,536,35,37,1439
1668,2019-08-16,66.52,245034,187945,122668,179757,735404,894,607,37,38,1576
1669,2019-08-19,66.89,249447,197332,135757,187872,770408,909,651,41,39,1640
1670,2019-08-20,66.565,256260,205473,139507,190294,791534,928,657,40,39,1664
1671,2019-08-21,65.75,268160,233061,157832,192931,851984,998,672,41,40,1751
1672,2019-08-22,65.6,254395,217052,155060,192403,818910,932,565,37,39,1573
1673,2019-08-23,65.985,265224,217016,143601,191809,817650,999,651,39,40,1729
1674,2019-08-26,66.07,270642,222513,145265,193394,831814,1038,673,41,42,1794
1675,2019-08-27,66.4425,274693,238739,158946,194900,867278,1029,686,39,42,1796
1676,2019-08-28,66.8,282388,243639,159639,198388,884054,1011,708,39,45,1803
1677,2019-08-29,66.59,266027,233711,162954,195270,857962,937,582,40,42,1601
1678,2019-08-30,66.79,267710,241781,172904,198833,881228,951,659,42,44,1696
1679,2019-09-02,66.79,270377,243476,172678,199579,886110,978,683,43,44,1748
1680,2019-09-03,66.7575,274937,257765,185063,202235,920000,1005,694,42,45,1786
1681,2019-09-04,66.2225,284793,263854,185001,205940,939588,1045,696,43,45,1829
1682,2019-09-05,66.215,275120,251950,177797,200967,905834,998,618,41,42,1699
1683,2019-09-06,65.73,290894,261515,177997,207376,937782,1077,674,41,46,1838
1684,2019-09-09,65.55,301038,265688,182337,217687,966750,1115,685,43,48,1891
1685,2019-09-10,65.42,302276,268135,183857,217998,972266,1134,692,42,47,1915
1686,2019-09-11,65.5,300851,276331,206862,231382,1015426,1155,697,42,49,1943
1687,2019-09-12,64.7,318576,281770,201475,238281,1040102,1157,612,40,42,1851
1688,2019-09-13,64.3375,346644,302186,204447,248905,1102182,1237,646,40,47,1970
1689,2019-09-16,64.045,370300,308774,211051,272577,1162702,1320,665,40,45,2070
1690,2019-09-17,64.36,373819,313683,219640,279776,1186918,1363,688,41,45,2137
1691,2019-09-18,64.15,397589,330535,225537,292591,1246252,1395,701,42,47,2185
1692,2019-09-19,64.005,148210,114430,48544,82324,393508,895,446,32,31,1404
1693,2019-09-20,64.01,159195,122879,50117,86433,418624,1009,502,32,34,1577
1694,2019-09-23,63.835,164651,125373,50802,90080,430906,1084,535,34,34,1687
1695,2019-09-24,63.985,192613,148795,52563,96381,490352,1174,567,34,35,1810
1696,2019-09-25,64.145,201071,155404,52334,98001,506810,1187,597,35,38,1857
1697,2019-09-26,64.21,195348,149748,52633,98233,495962,1131,525,34,35,1725
1698,2019-09-27,64.6975,200641,154370,52838,99109,506958,1201,588,35,38,1862
1699,2019-09-30,64.865,206663,159989,54358,101032,522042,1187,625,37,40,1889
1700,2019-10-01,65.265,213134,167197,55256,101193,536780,1122,664,36,40,1862
1701,2019-10-02,65.195,221061,174953,59017,105125,560156,1132,687,37,42,1898
1702,2019-10-03,65.1275,214854,178864,66965,102955,563638,1068,603,35,39,1745
1703,2019-10-04,64.615,228477,189686,67768,106559,592490,1153,653,36,40,1882
1704,2019-10-07,64.975,229599,192901,70261,106959,599720,1165,688,36,41,1930
1705,2019-10-08,65.2,234275,198331,71454,107398,611458,1181,709,36,41,1967
1706,2019-10-09,64.8875,240558,202439,70896,109015,622908,1226,711,37,42,2016
1707,2019-10-10,64.4575,236778,200948,70183,106013,613922,1176,617,35,39,1867
1708,2019-10-11,64.205,254003,214486,70761,110278,649528,1261,673,36,41,2011
1709,2019-10-14,64.295,260562,222780,72269,110051,665662,1275,701,36,41,2053
1710,2019-10-15,64.275,261499,223253,73422,111668,669842,1279,709,37,40,2065
1711,2019-10-16,64.075,265781,227984,74108,111905,679778,1285,716,38,42,2081
1712,2019-10-17,64.115,204611,174951,65461,95121,540144,1010,513,36,31,1590
1713,2019-10-18,63.76,220723,188316,65871,98278,573188,1117,622,37,34,1810
1714,2019-10-21,63.73,231835,202077,71588,101346,606846,1204,653,41,34,1932
1715,2019-10-22,63.735,239019,207932,70825,101912,619688,1260,683,40,35,2018
1716,2019-10-23,63.95,246861,209901,69808,106768,633338,1306,708,40,38,2092
1717,2019-10-24,64.07,252712,206244,66649,113117,638722,1224,612,38,34,1908
1718,2019-10-25,63.8525,265638,211214,67697,122121,666670,1320,666,39,37,2062
1719,2019-10-28,63.75,272650,220826,74128,125952,693556,1399,693,40,37,2169
1720,2019-10-29,63.95,284019,222449,74723,136293,717484,1427,711,41,36,2215
1721,2019-10-30,63.835,288790,228463,76467,136794,730514,1457,732,43,40,2272
1722,2019-10-31,64.13,287301,221204,70391,136488,715384,1387,627,41,34,2089
1723,2019-11-01,63.54,298083,238849,83574,142808,763314,1498,700,41,36,2275
1724,2019-11-05,63.4925,310406,259224,93878,145060,808568,1531,728,41,36,2336
1725,2019-11-06,63.8725,314968,268952,101412,147428,832760,1536,755,41,36,2368
1726,2019-11-07,63.52,308246,261958,103172,149460,822836,1458,662,42,36,2198
1727,2019-11-08,63.8,330733,283642,115176,162267,891818,1509,764,44,39,2356
1728,2019-11-11,63.89,338083,288867,115894,165110,907954,1535,782,44,39,2400
1729,2019-11-12,64.23,351756,295592,117888,174052,939288,1538,802,44,40,2424
1730,2019-11-13,64.35,356302,293702,118164,180764,948932,1533,823,44,41,2441
1731,2019-11-14,63.98,346139,277630,109669,178178,911616,1492,684,44,36,2256
1732,2019-11-15,63.7675,357958,297759,123298,183497,962512,1550,769,47,42,2408
1733,2019-11-18,63.8225,359828,300451,124724,184101,969104,1571,802,49,43,2465
1734,2019-11-19,63.82,360420,300588,125451,185283,971742,1584,816,49,42,2491
1735,2019-11-20,63.89,363482,301831,129297,190948,985558,1584,834,49,44,2511
1736,2019-11-21,63.72,277093,201312,75660,151441,705506,1310,610,44,33,1997
1737,2019-11-22,63.87,287815,223019,102286,167082,780202,1400,728,45,38,2211
1738,2019-11-25,63.94,297162,231655,108124,173631,810572,1417,777,46,39,2279
1739,2019-11-26,63.95,299182,234291,109372,174263,817108,1433,802,47,39,2321
1740,2019-11-27,63.96,304666,244819,116611,176458,842554,1464,827,47,41,2379
1741,2019-11-28,64.07,301142,226205,108142,183079,818568,1391,661,46,36,2134
1742,2019-11-29,64.3175,306626,236750,113754,183630,840760,1410,750,47,37,2244
1743,2019-12-02,64.175,310728,253257,134358,191829,890172,1449,799,50,37,2335
1744,2019-12-03,64.145,313573,261013,143404,195964,913954,1502,810,52,38,2402
1745,2019-12-04,63.95,326845,282612,160471,204704,974632,1512,810,51,38,2411
1746,2019-12-05,63.7225,323401,250003,154322,227720,955446,1475,674,49,36,2234
1747,2019-12-06,63.755,332152,262179,160732,230705,985768,1521,735,51,38,2345
1748,2019-12-09,63.59,338886,274149,170803,235540,1019378,1550,757,50,41,2398
1749,2019-12-10,63.4925,342514,291784,198540,249270,1082108,1565,778,50,41,2434
1750,2019-12-11,63.27,344376,301616,210213,252973,1109178,1573,791,51,42,2457
1751,2019-12-12,62.8425,361859,293676,204300,272483,1132318,1566,675,51,38,2330
1752,2019-12-13,62.8975,394002,327148,224026,290880,1236056,1655,709,52,39,2455
1753,2019-12-16,62.445,408991,337613,230991,302369,1279964,1698,717,51,38,2504
1754,2019-12-17,62.415,413709,347588,239319,305440,1306056,1704,726,50,38,2518
1755,2019-12-18,62.665,435712,366900,245878,314690,1363180,1695,743,51,41,2530
1756,2019-12-19,62.405,137616,177192,145011,105435,565254,893,454,29,25,1401
1757,2019-12-20,62.2525,186830,206258,147447,128019,668554,996,548,37,32,1613
1758,2019-12-23,62.265,202559,225730,153704,130533,712526,1059,588,37,32,1716
1759,2019-12-24,61.9675,217327,242289,156636,131674,747926,1104,603,37,31,1775
1760,2019-12-25,61.85,230081,261466,167969,136584,796100,1168,627,39,32,1866
1761,2019-12-26,62.215,203122,220024,156225,139323,718694,1086,511,37,29,1663
1762,2019-12-27,62.0325,210546,239337,178862,150071,778816,1142,584,39,29,1794
1763,2019-12-30,61.985,218443,269797,210373,159019,857632,1185,616,41,29,1871
1764,2020-01-03,62.1,222719,274101,210413,159031,866264,1215,642,39,29,1925
1765,2020-01-06,61.82,223602,281038,217984,160548,883172,1242,659,40,29,1970
1766,2020-01-08,61.2475,237974,288704,218601,167871,913150,1278,680,41,29,2028
1767,2020-01-09,61.2925,245280,287327,221205,179158,932970,1279,603,40,27,1949
1768,2020-01-10,61.06,255477,299444,227254,183287,965462,1334,666,41,29,2070
1769,2020-01-13,61.2725,263202,306001,270794,227995,1067992,1364,712,41,30,2147
1770,2020-01-14,61.445,267205,309997,271835,229043,1078080,1388,722,42,30,2182
1771,2020-01-15,61.4175,275902,322216,276912,230598,1105628,1397,743,43,33,2216
1772,2020-01-16,61.6625,195728,179477,133068,149319,657592,1046,510,34,28,1618
1773,2020-01-17,61.555,217265,202056,135133,150342,704796,1141,591,35,31,1798
1774,2020-01-20,61.5475,228461,213462,137014,152013,730950,1195,636,36,32,1899
1775,2020-01-21,61.8825,229342,213904,137218,152656,733120,1206,649,36,32,1923
1776,2020-01-22,61.8425,236499,219510,136893,153882,746784,1226,670,38,32,1966
1777,2020-01-23,61.905,222609,205797,136854,153666,718926,1144,566,37,28,1775
1778,2020-01-24,62.07,231259,214055,137258,154462,737034,1222,626,39,30,1917
1779,2020-01-27,62.97,240714,218831,136590,158473,754608,1198,687,42,31,1958
1780,2020-01-28,62.2925,257172,233487,140074,163759,794492,1255,698,44,31,2028
1781,2020-01-29,62.54,258268,232834,140111,165545,796758,1258,718,44,31,2051
1782,2020-01-30,63.26,242952,217770,139814,164996,765532,1170,609,40,31,1850
1783,2020-01-31,63.915,247098,225084,143617,165631,781430,1188,676,42,33,1939
1784,2020-02-03,63.725,261587,239305,143310,165592,809794,1214,713,42,35,2004
1785,2020-02-04,63.105,268227,246609,144495,166113,825444,1308,734,42,34,2118
1786,2020-02-05,62.87,287809,263668,145116,169257,865850,1371,733,43,34,2181
1787,2020-02-06,63.355,270131,247553,147079,169657,834420,1233,638,44,32,1947
1788,2020-02-07,64.125,293442,260605,149961,182798,886806,1207,713,43,39,2002
1789,2020-02-10,64.13,309501,277850,166495,198146,951992,1243,754,44,41,2082
1790,2020-02-11,63.3725,323403,283850,165073,204626,976952,1313,744,44,42,2143
1791,2020-02-12,63.2125,351736,304488,165912,213160,1035296,1383,743,44,42,2212
1792,2020-02-13,63.6325,329819,281867,160627,208579,980892,1250,637,43,38,1968
1793,2020-02-14,63.5625,338822,290616,164086,212292,1005816,1303,697,43,39,2082
1794,2020-02-17,63.4675,337612,295806,171749,213555,1018722,1326,729,40,41,2136
1795,2020-02-18,63.81,341991,297150,173864,218705,1031710,1289,753,40,43,2125
1796,2020-02-19,63.575,338311,301198,175404,212517,1027430,1299,746,41,42,2128
1797,2020-02-20,64.2,270250,244629,149047,174668,838594,1067,582,36,38,1723
1798,2020-02-21,64.0725,278574,266381,161152,173345,879452,1110,695,38,39,1882
1799,2020-02-25,65.385,289148,272063,163163,180248,904622,1042,738,37,40,1857
1800,2020-02-26,65.47,295751,276764,164451,183438,920404,1077,751,38,41,1907
1801,2020-02-27,66.015,280395,261681,164366,183080,889522,981,644,38,34,1697
1802,2020-02-28,66.8775,293394,283192,194441,204643,975670,977,711,38,36,1762
1803,2020-03-02,66.4425,308637,289237,198229,217629,1013732,972,751,38,35,1796
1804,2020-03-03,66.04,319843,293332,194752,221263,1029190,1055,756,38,34,1883
1805,2020-03-04,66.26,331396,296408,195277,230265,1053346,1109,764,39,38,1950
1806,2020-03-05,67.62,316354,277214,188168,227308,1009044,1023,647,34,37,1741
1807,2020-03-06,68.5725,331532,298004,204913,238441,1072890,1024,731,40,37,1832
1808,2020-03-10,71.4,313433,265190,202991,251234,1032848,995,748,41,39,1823
1809,2020-03-11,72.95,319899,267475,205473,257897,1050744,1033,767,43,36,1879
1810,2020-03-12,74.85,301643,252764,197731,246610,998748,973,664,38,35,1710
1811,2020-03-13,72.5975,314471,265633,203122,251960,1035186,1071,704,44,37,1856
1812,2020-03-16,74.6525,318694,267780,203686,254600,1044760,1101,741,44,37,1923
1813,2020-03-17,75.4425,324620,272544,204762,256838,1058764,1124,770,45,37,1976
1814,2020-03-18,80.87,328680,242072,158781,245389,974922,1031,784,42,37,1894
1815,2020-03-19,79.125,85046,60737,64469,88778,299030,564,307,21,23,915
1816,2020-03-20,79.9325,106556,76594,66614,96576,346340,705,379,23,27,1134
1817,2020-03-23,79.6,117638,83457,68035,102216,371346,810,430,27,29,1296
1818,2020-03-24,78.28,122674,87809,68522,103387,382392,877,454,30,29,1390
1819,2020-03-25,78.25,133717,94154,73295,112858,414024,943,461,30,27,1461
1820,2020-03-26,77.4675,120115,79092,71281,112304,382792,859,344,29,26,1258
1821,2020-03-27,78.82,134331,93393,74423,115361,417508,964,463,30,28,1485
1822,2020-03-30,79.32,142576,97327,74988,120237,435128,1048,517,34,28,1627
1823,2020-03-31,78.3725,151571,105632,77061,123000,457264,1102,545,36,29,1712
1824,2020-04-01,78.79,162718,108026,77574,132266,480584,1129,573,37,29,1768
1825,2020-04-02,77.25,148804,98333,75945,126416,449498,1044,446,35,27,1552
1826,2020-04-03,76.4925,155448,105654,77640,127434,466176,1130,515,35,26,1706
1827,2020-04-06,76.02,168252,118791,81558,131019,499620,1209,550,37,28,1824
1828,2020-04-07,75.54,187999,138249,81708,131458,539414,1290,567,38,29,1924
1829,2020-04-08,74.9725,190652,144206,86529,132975,554362,1351,579,38,31,1999
1830,2020-04-09,74.3,205245,143124,83988,146109,578466,1321,467,39,28,1855
1831,2020-04-10,73.75,218297,155417,84439,147319,605472,1383,563,39,30,2015
1832,2020-04-13,73.61,227041,163662,87389,150768,628860,1449,594,40,31,2114
1833,2020-04-14,73.0025,238541,171615,88839,155765,654760,1483,615,40,33,2171
1834,2020-04-15,74.8125,247131,171597,89340,164874,672942,1442,658,41,34,2175
1835,2020-04-16,74.15,156579,97198,78069,137450,469296,1107,421,35,31,1594
1836,2020-04-17,73.99,165903,106664,84281,143520,500368,1199,528,35,32,1794
1837,2020-04-20,75.55,198270,113136,94111,179245,584762,1249,581,36,32,1898
1838,2020-04-21,77.08,206896,117238,97445,187103,608682,1232,612,36,33,1913
1839,2020-04-22,75.9025,211966,122810,98749,187905,621430,1249,632,36,34,1951
1840,2020-04-23,74.77,197681,104250,86580,180011,568522,1145,461,36,30,1672
1841,2020-04-24,74.545,214350,113253,97952,199049,624604,1252,540,38,32,1862
1842,2020-04-27,74.495,220137,118941,98434,199630,637142,1336,587,38,32,1993
1843,2020-04-28,74.1425,224289,123275,100610,201624,649798,1376,614,38,33,2061
1844,2020-04-29,73.01,233226,130654,101147,203719,668746,1413,610,39,33,2095
1845,2020-04-30,74.395,251347,130913,97201,217635,697096,1294,526,38,32,1890
1846,2020-05-04,74.845,278181,140102,97385,235464,751132,1339,616,38,33,2026
1847,2020-05-05,73.75,287022,137583,97125,246564,768294,1416,612,38,33,2099
1848,2020-05-06,74.58,296687,141401,97725,253011,788824,1413,630,39,33,2115
1849,2020-05-07,74.1,288578,127983,87527,248122,752210,1358,501,37,32,1928
1850,2020-05-08,73.4,295244,145483,101952,251713,794392,1462,588,38,32,2120
1851,2020-05-12,73.71,311009,150335,101896,262570,825810,1518,617,38,32,2205
1852,2020-05-13,73.94,329840,161123,109513,278230,878706,1549,649,41,32,2271
1853,2020-05-14,73.48,319067,150676,100491,268882,839116,1454,552,40,30,2076
1854,2020-05-15,73.58,322121,161986,112980,273115,870202,1511,617,39,30,2197
1855,2020-05-18,72.6775,329185,167661,114095,275619,886560,1577,643,38,31,2289
1856,2020-05-19,72.465,329836,176056,122990,276770,905652,1610,658,38,32,2338
1857,2020-05-20,71.09,330753,206003,123568,248318,908642,1670,669,40,31,2410
1858,2020-05-21,70.9675,257550,169425,104579,192704,724258,1435,495,33,27,1990
1859,2020-05-22,71.64,272033,174673,107399,204759,758864,1496,606,33,29,2164
1860,2020-05-25,71.65,282039,184059,107609,205589,779296,1558,647,33,29,2267
1861,2020-05-26,70.78,313740,190770,110053,233023,847586,1637,652,34,29,2352
1862,2020-05-27,71.01,322859,203102,116164,235921,878046,1668,686,34,29,2417
1863,2020-05-28,70.485,319456,185247,106475,240684,851862,1540,541,33,28,2142
1864,2020-05-29,70.1425,338631,197028,105325,246928,887912,1614,644,34,31,2323
1865,2020-06-01,69.12,364250,215373,114270,263147,957040,1703,681,34,30,2448
1866,2020-06-02,68.73,392038,228366,123349,287021,1030774,1824,699,35,33,2591
1867,2020-06-03,68.665,406953,241124,128195,294024,1070296,1892,707,37,33,2669
1868,2020-06-04,69.1525,409656,212139,112485,310002,1044282,1763,604,37,27,2431
1869,2020-06-05,68.7,421329,215277,116871,322923,1076400,1888,677,37,28,2630
1870,2020-06-08,68.2,431159,225705,116078,321532,1094474,1951,701,38,28,2718
1871,2020-06-09,68.585,439956,235718,118789,323027,1117490,1986,725,39,28,2778
1872,2020-06-10,68.5,448823,246584,122137,324376,1141920,2020,740,39,29,2828
1873,2020-06-11,70.2,437096,236670,116304,316730,1106800,1879,667,37,28,2611
1874,2020-06-15,69.5775,439198,247095,121459,313562,1121314,1910,739,39,29,2717
1875,2020-06-16,69.6175,447876,253394,124593,319075,1144938,1957,755,39,30,2781
1876,2020-06-17,69.74,460899,264548,125633,321984,1173064,1970,764,39,30,2803
1877,2020-06-18,69.8625,122813,79667,76315,119461,398256,1040,426,28,22,1516
1878,2020-06-19,69.4375,138570,87188,76335,127717,429810,1172,512,29,24,1737
1879,2020-06-22,69.02,144477,92759,84236,135954,457426,1256,552,30,23,1861
1880,2020-06-23,68.8625,161145,100376,83981,144750,490252,1325,569,31,26,1951
1881,2020-06-25,69.02,160082,87529,67320,139873,454804,1275,434,31,22,1762
1882,2020-06-26,69.8,184685,106903,76237,154019,521844,1328,560,35,31,1954
1883,2020-06-29,69.99,214692,118535,79084,175241,587552,1418,628,36,33,2115
1884,2020-06-30,71.2775,228978,124919,89257,193316,636470,1422,666,36,33,2157
1885,2020-07-02,70.5525,215713,111167,67616,172162,566658,1438,535,33,26,2032
1886,2020-07-03,71.37,234640,122052,70276,182864,609832,1501,634,36,30,2201
1887,2020-07-06,71.8275,242661,130909,72928,184680,631178,1537,681,36,31,2285
1888,2020-07-07,71.4725,260191,149632,84676,195235,689734,1578,709,39,31,2357
1889,2020-07-08,71.11,266107,154464,88782,200425,709778,1634,723,41,32,2430
1890,2020-07-09,70.915,251907,142668,90432,199671,684678,1545,596,37,29,2207
1891,2020-07-10,70.7275,262217,153863,93652,202006,711738,1612,695,41,31,2379
1892,2020-07-13,70.97,265954,156943,92708,201719,717324,1654,714,42,32,2442
1893,2020-07-14,70.865,273053,158979,94566,208640,735238,1680,749,45,31,2505
1894,2020-07-15,70.99,277211,162450,96525,211286,747472,1679,756,47,32,2514
1895,2020-07-16,71.53,185225,106286,82199,161138,534848,1296,489,43,26,1854
1896,2020-07-17,71.8725,198745,116915,83457,165287,564404,1391,648,46,34,2119
1897,2020-07-20,71.3325,204733,121389,83280,166624,576026,1471,681,47,35,2234
1898,2020-07-21,70.705,228924,133890,74761,169795,607370,1539,693,47,34,2313
1899,2020-07-22,71.0575,234030,138388,75484,171126,619028,1570,716,47,36,2369
1900,2020-07-23,71.47,215104,119789,68829,164144,567866,1412,554,41,29,2036
1901,2020-07-24,71.735,223564,128675,69107,163996,585342,1486,679,42,30,2237
1902,2020-07-27,71.5725,228216,132467,68873,164622,594178,1558,712,43,32,2345
1903,2020-07-28,72.59,233774,138819,69992,164947,607532,1550,751,44,35,2380
1904,2020-07-29,72.57,260806,144641,70363,186528,662338,1629,778,45,36,2488
1905,2020-07-30,73.17,260912,142516,71978,190374,665780,1451,631,42,28,2152
1906,2020-07-31,74.42,275036,153226,73903,195713,697878,1492,710,43,31,2276
1907,2020-08-03,73.1125,297748,167883,74128,203993,743752,1544,734,44,31,2353
1908,2020-08-04,73.56,313647,176509,76861,213999,781016,1599,762,44,33,2438
1909,2020-08-05,72.88,327843,183021,72403,217225,800492,1653,750,43,32,2478
1910,2020-08-06,73.2825,316088,169891,70904,217101,773984,1519,624,40,30,2213
1911,2020-08-07,73.7275,332656,183574,76769,225851,818850,1588,722,43,32,2385
1912,2020-08-10,73.4725,335596,186274,77333,226655,825858,1626,756,43,33,2458
1913,2020-08-11,73.11,352069,191919,76986,237136,858110,1695,762,43,33,2533
1914,2020-08-12,73.7125,354576,194417,77161,237320,863474,1678,790,42,32,2542
1915,2020-08-13,72.9425,347564,185736,70647,232475,836422,1588,671,41,29,2329
1916,2020-08-14,72.875,358413,196271,72965,235107,862756,1684,743,40,30,2497
1917,2020-08-17,73.735,362434,201888,75079,235625,875026,1676,766,40,30,2512
1918,2020-08-18,73.16,373948,207621,77395,243722,902686,1750,785,43,31,2609
1919,2020-08-19,73.3025,397235,210491,79025,265769,952520,1770,801,43,33,2647
1920,2020-08-20,73.79,337376,158215,69106,248267,812964,1491,570,41,28,2130
1921,2020-08-21,74.8,354047,172694,75628,256981,859350,1542,704,44,29,2319
1922,2020-08-24,74.6675,358712,176364,75438,257786,868300,1623,719,44,29,2415
1923,2020-08-25,75.3275,369317,184204,78688,263801,896010,1605,758,48,31,2442
1924,2020-08-26,75.3775,377608,194241,81493,264860,918202,1591,783,49,34,2457
1925,2020-08-27,74.965,362524,176749,73421,259196,871890,1509,633,44,28,2214
1926,2020-08-28,74.0125,378788,192452,75541,261877,908658,1652,700,44,30,2426
1927,2020-08-31,74.075,390461,209663,82091,262889,945104,1752,749,48,32,2581
1928,2020-09-01,73.5775,402127,220344,84318,266101,972890,1826,754,47,32,2659
1929,2020-09-02,75.41,416372,223562,88452,281262,1009648,1678,789,47,33,2547
1930,2020-09-03,75.28,409744,211144,88766,287366,997020,1574,684,44,31,2333
1931,2020-09-04,75.4325,418928,227055,97709,289582,1033274,1647,771,46,33,2497
1932,2020-09-07,75.77,419928,230233,99553,289248,1038962,1651,821,48,34,2554
1933,2020-09-08,76.28,427984,234529,118349,311804,1092666,1653,846,48,34,2581
1934,2020-09-09,75.325,436794,245514,119790,311070,1113168,1699,835,48,34,2616
1935,2020-09-10,75.2525,434084,233831,107614,307867,1083396,1628,720,46,31,2425
1936,2020-09-11,75.05,440770,248462,112262,304570,1106064,1716,823,49,32,2620
1937,2020-09-14,75.2725,445058,251605,112118,305571,1114352,1698,834,49,33,2614
1938,2020-09-15,74.99,449093,255656,112800,306237,1123786,1703,851,49,33,2636
1939,2020-09-16,74.97,454125,260524,113117,306718,1134484,1717,850,51,34,2652
1940,2020-09-17,75.17,146245,73756,30983,103472,354456,951,466,35,26,1478
1941,2020-09-18,75.745,204527,143240,86779,148066,582612,1087,616,35,30,1768
1942,2020-09-21,76.13,220043,161594,90391,148840,620868,1116,696,37,31,1880
1943,2020-09-22,76.1075,229205,167210,90074,152069,638558,1182,723,37,31,1973
1944,2020-09-23,77.0825,235008,174684,92819,153143,655654,1137,757,38,31,1963
1945,2020-09-24,77.14,218263,157301,91077,152039,618680,1038,606,38,29,1711
1946,2020-09-25,78.2075,231486,174002,97085,154569,657142,1053,718,40,31,1842
1947,2020-09-28,79.08,239712,179318,96732,157126,672888,1091,786,43,32,1952
1948,2020-09-29,79.0775,251990,190702,103582,164870,711144,1134,818,44,33,2029
1949,2020-09-30,77.63,268730,201592,103315,170453,744090,1242,823,45,34,2144
1950,2020-10-01,77.365,259326,182275,90197,167248,699046,1155,662,42,32,1891
1951,2020-10-02,78.2025,269939,201920,101065,169084,742008,1206,788,44,33,2071
1952,2020-10-05,78.105,280848,210556,101300,171592,764296,1269,820,44,34,2167
1953,2020-10-06,78.465,287953,218364,101882,171471,779670,1292,824,44,34,2194
1954,2020-10-07,78.0225,304475,230166,100250,174559,809450,1337,847,43,34,2261
1955,2020-10-08,77.3575,274770,207570,101434,168634,752408,1272,692,42,31,2037
1956,2020-10-09,76.7675,340463,254839,102320,187944,885566,1381,817,43,32,2273
1957,2020-10-12,77.105,350717,265404,103498,188811,908430,1420,850,45,34,2349
1958,2020-10-13,77.05,358073,272874,103110,188309,922366,1442,877,47,33,2399
1959,2020-10-14,77.64,338085,259070,115158,194173,906486,1437,891,49,34,2411
1960,2020-10-15,78.075,224771,180566,92563,136768,634668,1075,669,42,29,1815
1961,2020-10-16,77.9375,239568,202009,102326,139885,683788,1199,764,44,30,2037
1962,2020-10-19,77.665,253680,214357,102388,141711,712136,1312,803,44,31,2190
1963,2020-10-20,77.34,265676,232431,109222,142467,749796,1347,838,45,31,2261
1964,2020-10-21,76.725,287502,247607,110334,150229,795672,1440,853,45,32,2370
1965,2020-10-22,76.5825,262135,217912,101530,145753,727330,1272,673,41,29,2015
1966,2020-10-23,76.125,282836,242167,106908,147577,779488,1405,804,43,32,2284
1967,2020-10-26,76.38,300905,262066,110136,148975,822082,1497,853,45,34,2429
1968,2020-10-27,77.31,312782,266358,113289,159713,852142,1484,887,44,34,2449
1969,2020-10-28,79.23,334454,278230,125903,182127,920714,1348,951,46,34,2379
1970,2020-10-29,78.875,324977,252998,119857,191836,889668,1223,770,43,32,2068
1971,2020-10-30,79.53,334294,267134,126998,194158,922584,1315,841,44,33,2233
1972,2020-11-02,80.55,336516,267808,128333,197041,929698,1362,899,45,34,2340
1973,2020-11-03,79.345,348212,276761,132492,203943,961408,1493,922,49,35,2499
1974,2020-11-05,77.0,335411,246806,118453,207058,907728,1465,743,46,29,2283
1975,2020-11-06,77.41,358172,271048,123068,210192,962480,1606,887,49,30,2572
1976,2020-11-09,76.28,379716,293117,128059,214658,1015550,1744,894,48,30,2716
1977,2020-11-10,76.55,395269,303472,135205,227002,1060948,1815,921,48,32,2816
1978,2020-11-11,77.1325,413798,321377,152964,245385,1133524,1849,934,46,33,2862
1979,2020-11-12,77.37,383632,295117,149836,238351,1066936,1633,796,44,28,2501
1980,2020-11-13,77.3875,397311,309952,151410,238769,1097442,1705,914,43,31,2693
1981,2020-11-16,76.16,405901,317446,150768,239223,1113338,1774,931,44,34,2783
1982,2020-11-17,76.22,411143,326431,156281,240993,1134848,1804,939,45,35,2823
1983,2020-11-18,76.06,427177,336489,159216,249904,1172786,1854,943,46,35,2878
1984,2020-11-19,76.05,317358,234272,101281,184367,837278,1498,704,41,29,2272
1985,2020-11-20,76.2,345221,260976,111823,196068,914088,1624,841,41,31,2537
1986,2020-11-23,76.175,354691,270821,114087,197957,937556,1678,897,41,32,2648
1987,2020-11-24,75.48,365377,280670,114258,198965,959270,1729,902,40,32,2703
1988,2020-11-25,75.5625,375632,288512,117555,204675,986374,1747,920,42,33,2742
1989,2020-11-26,75.715,342321,250799,108664,200186,901970,1613,773,41,30,2457
1990,2020-11-27,75.8525,363617,269116,110876,205377,948986,1713,908,40,31,2692
1991,2020-11-30,76.39,371598,275676,112541,208463,968278,1786,947,39,31,2803
1992,2020-12-01,75.8475,374717,282175,116889,209431,983212,1814,947,40,31,2832
1993,2020-12-02,75.07,388640,289919,117109,215830,1011498,1859,939,42,33,2873
1994,2020-12-03,74.45,375998,277761,119914,218151,991824,1751,774,43,32,2600
1995,2020-12-04,74.05,394987,308840,129804,215951,1049582,1867,888,42,33,2830
1996,2020-12-07,73.64,406823,328014,137902,216711,1089450,1939,917,44,34,2934
1997,2020-12-08,73.505,424847,338649,140667,226865,1131028,2005,936,43,34,3018
1998,2020-12-09,73.86,445789,349698,141002,237093,1173582,2054,954,44,34,3086
1999,2020-12-10,73.0475,426191,325516,135871,236546,1124124,1926,837,43,33,2839
2000,2020-12-10,73.0475,426191,325516,135871,236546,1124124,1926,837,43,33,2839
2001,2020-12-11,72.945,441024,343211,143019,240832,1168086,2003,926,43,35,3007
2002,2020-12-14,73.87,449096,351133,144074,242037,1186340,2016,950,44,35,3045
2003,2020-12-15,73.3925,455338,355554,144591,244375,1199858,2020,975,46,36,3077
2004,2020-12-16,73.3475,467128,355915,144953,256166,1224162,2026,979,46,38,3089
2005,2020-12-17,72.8325,127250,93898,27755,61107,310010,1092,494,27,26,1639
2006,2020-12-18,73.3475,149438,112847,33434,70025,365744,1188,621,31,29,1869
2007,2020-12-21,74.8,172522,141517,43149,74154,431342,1196,696,33,30,1955
2008,2020-12-22,75.91,182893,162602,57192,77483,480170,1254,740,35,30,2059
2009,2020-12-23,75.08,191896,177338,65503,80061,514798,1337,774,37,30,2178
2010,2020-12-24,73.895,155819,159690,80995,77124,473628,1272,573,37,25,1907
2011,2020-12-25,74.17,182330,184847,90672,88155,546004,1425,688,37,25,2175
2012,2020-12-28,73.77,193703,196353,92579,89929,572564,1466,712,37,26,2241
2013,2020-12-29,74.0375,204951,218124,107455,94282,624812,1468,744,37,26,2275
2014,2020-12-30,74.415,186823,210592,114593,90824,602832,1290,663,36,27,2016
2015,2021-01-04,74.33,205092,225766,115375,94701,640934,1440,719,36,27,2222
2016,2021-01-05,74.04,216416,238630,118970,96756,670772,1437,781,37,27,2282
2017,2021-01-06,73.9225,207646,229322,114234,92558,643760,1420,672,33,25,2150
2018,2021-01-08,74.155,220655,240049,113969,94575,669248,1521,764,34,27,2346
2019,2021-01-11,74.66,237247,253714,118495,102028,711484,1564,823,34,27,2448
2020,2021-01-12,73.54,256050,272267,121444,105227,754988,1693,833,37,28,2591
2021,2021-01-13,73.7475,265611,282980,125986,108617,783194,1765,843,37,28,2673
2022,2021-01-14,73.21,249539,267697,124645,106487,748368,1664,722,37,26,2449
2023,2021-01-15,73.645,264139,283497,126163,106805,780604,1757,834,37,26,2654
2024,2021-01-18,73.995,277015,292586,134013,118442,822056,1804,873,41,27,2745
2025,2021-01-19,73.68,287931,306006,138143,120068,852148,1837,899,41,28,2805
2026,2021-01-20,73.52,305177,320464,139136,123849,888626,1879,904,42,28,2853
2027,2021-01-21,73.845,225077,177123,47081,95035,544316,1427,610,36,26,2099
2028,2021-01-22,75.3,251091,203204,39886,87773,581954,1498,813,39,27,2377
2029,2021-01-25,75.3675,263053,212794,40627,90886,607360,1595,873,40,27,2535
2030,2021-01-26,75.085,273453,220367,44676,97762,636258,1644,906,41,28,2619
2031,2021-01-27,75.85,286589,230892,46790,102487,666758,1632,931,39,28,2630
2032,2021-01-28,75.9575,272753,215606,45750,102897,637006,1446,733,38,29,2246
2033,2021-01-29,75.755,291016,237444,50780,104352,683592,1623,816,39,31,2509
2034,2021-02-01,76.1475,295283,240778,51171,105676,692908,1642,853,39,31,2565
2035,2021-02-02,76.225,305008,247105,50042,107945,710100,1686,865,37,32,2620
2036,2021-02-03,75.9275,312207,253110,50002,109099,724418,1767,912,37,31,2747
2037,2021-02-04,75.505,293648,235315,47621,105954,682538,1599,764,37,26,2426
2038,2021-02-05,74.645,309632,250034,48906,108504,717076,1760,840,38,29,2667
2039,2021-02-08,74.3,335995,262150,51379,125224,774748,1843,881,38,29,2791
2040,2021-02-09,73.8875,349521,275832,55127,128816,809296,1919,904,39,29,2891
2041,2021-02-10,73.945,363363,282809,54161,134715,835048,1993,922,39,30,2984
2042,2021-02-11,73.605,339745,261196,52664,131213,784818,1861,792,37,28,2718
2043,2021-02-12,73.7175,370758,277938,53536,146356,848588,1942,902,37,28,2909
2044,2021-02-15,73.325,380687,294315,61434,147806,884242,2014,900,39,29,2982
2045,2021-02-16,73.64,401012,309623,65220,156609,932464,2048,918,38,30,3034
2046,2021-02-17,73.71,407383,310967,70227,166643,955220,2013,958,38,31,3040
2047,2021-02-18,73.91,340982,237821,53916,157077,789796,1675,685,36,25,2421
2048,2021-02-19,74.125,359993,256963,62478,165508,844942,1800,826,38,28,2692
2049,2021-02-20,74.08,361611,259353,64996,167254,853214,1829,859,38,28,2754
2050,2021-02-22,74.3,365024,261696,65049,168377,860146,1767,909,37,31,2744
2051,2021-02-24,73.54,369840,266978,65164,168026,870008,1885,897,37,32,2851
2052,2021-02-25,74.75,355913,253051,61649,164511,835124,1741,764,38,29,2572
2053,2021-02-26,74.63,374797,257671,64174,181300,877942,1745,912,39,32,2728
2054,2021-03-01,74.165,380465,265451,67857,182871,896644,1828,939,40,33,2840
2055,2021-03-02,73.81,388343,275780,70701,183264,918088,1897,957,41,34,2929
2056,2021-03-03,73.97,393127,281456,71640,183311,929534,1929,974,42,33,2978
2057,2021-03-04,74.7,375688,266397,72809,182100,896994,1805,830,40,32,2707
2058,2021-03-05,74.2025,400941,277546,66940,190335,935762,1764,998,42,34,2838
2059,2021-03-09,73.915,403752,287649,75778,191881,959060,1821,1019,42,33,2915
2060,2021-03-10,73.6025,415741,296625,74472,193588,980426,1876,1024,42,33,2975
2061,2021-03-11,73.3,395921,277042,80510,199389,952862,1809,864,43,29,2745
2062,2021-03-12,73.33,405075,287793,92913,210195,995976,1874,938,46,32,2890
2063,2021-03-15,72.805,409218,286658,84786,207346,988008,1875,947,44,31,2897
2064,2021-03-16,72.85,417861,292050,85846,211657,1007414,1899,971,44,31,2945
2065,2021-03-17,73.64,439727,300937,91956,230746,1063366,1837,1016,42,35,2930
2066,2021-03-18,74.3025,187298,116716,37469,108051,449534,995,602,25,27,1649
2067,2021-03-19,74.115,219384,124878,34327,128833,507422,1181,709,25,27,1942
2068,2021-03-22,74.94,234877,136549,35074,133402,539902,1232,792,26,27,2077
2069,2021-03-23,76.39,279944,147041,38461,171364,636810,1212,848,28,31,2119
2070,2021-03-24,76.5775,308531,166059,43868,186340,704798,1273,890,30,32,2225
2071,2021-03-25,76.21,277289,136273,40211,181227,635000,1162,694,29,30,1915
2072,2021-03-26,75.655,302867,157525,40999,186341,687732,1299,758,29,30,2116
2073,2021-03-29,75.68,314385,168759,42681,188307,714132,1353,816,30,29,2228
2074,2021-03-30,75.85,326202,180263,49418,195357,751240,1397,856,30,30,2313
2075,2021-03-31,75.69,334882,187234,49703,197351,769170,1473,853,29,31,2386
2076,2021-04-01,76.2575,298075,159227,56425,195273,709000,1266,774,29,31,2100
2077,2021-04-02,76.5525,312766,177670,61426,196522,748384,1340,849,31,33,2253
2078,2021-04-05,76.39,326704,181357,63631,208978,780670,1416,875,36,33,2360
2079,2021-04-06,77.265,348394,189048,67412,226758,831612,1401,902,37,36,2376
2080,2021-04-07,76.98,382554,205627,74850,251777,914808,1471,934,38,35,2478
2081,2021-04-08,76.855,360382,184515,69830,245697,860424,1402,787,36,32,2257
2082,2021-04-09,77.395,373420,195978,73402,250844,893644,1465,888,36,38,2427
2083,2021-04-12,77.385,381141,201577,73223,252787,908728,1530,935,38,38,2541
2084,2021-04-13,75.94,386987,210145,76732,253574,927438,1591,943,40,39,2613
2085,2021-04-14,75.87,407548,227803,77618,257363,970332,1696,943,39,39,2717
2086,2021-04-15,76.325,320388,161342,259608,418654,1159992,1262,662,35,33,1992
2087,2021-04-16,75.8175,359998,211244,267159,415913,1254314,1427,790,36,38,2291
2088,2021-04-19,76.35,373531,226994,272152,418689,1291366,1565,841,37,38,2481
2089,2021-04-20,76.83,390519,238403,272181,424297,1325400,1562,895,38,40,2535
2090,2021-04-21,76.6,412877,252424,272464,432917,1370682,1639,921,38,41,2639
2091,2021-04-22,75.4175,374013,210276,267702,431439,1283430,1506,742,37,35,2320
2092,2021-04-23,74.98,428809,235513,269136,462432,1395890,1716,850,37,38,2641
2093,2021-04-26,74.97,439400,237108,270393,472685,1419586,1816,890,36,39,2781
2094,2021-04-27,74.89,449644,238271,270505,481878,1440298,1890,906,36,38,2870
2095,2021-04-28,74.4125,461069,245892,268912,484089,1459962,1955,915,36,40,2946
2096,2021-04-29,74.635,447997,224930,267345,490412,1430684,1707,764,38,33,2542
2097,2021-04-30,75.21,462474,239241,267084,490317,1459116,1787,886,37,40,2750
2098,2021-05-04,74.8425,469889,247262,268240,490867,1476258,1826,929,41,41,2837
2099,2021-05-05,74.86,493369,268107,269095,494357,1524928,1883,937,42,43,2905
2100,2021-05-06,74.23,479382,253655,268806,494533,1496376,1777,783,40,35,2635
2101,2021-05-07,73.785,506701,279500,270110,497311,1553622,1859,847,39,40,2785
2102,2021-05-10,74.35,518555,292155,270244,496644,1577598,1914,888,39,41,2882
2103,2021-05-11,74.11,531501,295433,274258,510326,1611518,1953,899,40,42,2934
2104,2021-05-12,74.63,537753,301330,275148,511571,1625802,1957,923,40,43,2963
2105,2021-05-13,74.0775,566454,281130,269208,554532,1671324,1847,776,39,37,2699
2106,2021-05-14,74.0125,578268,289513,268034,556789,1692604,1922,874,38,41,2875
2107,2021-05-17,73.8,585849,300095,269403,555157,1710504,1956,911,38,41,2946
2108,2021-05-18,73.7,592608,314057,275890,554441,1736996,1977,938,39,40,2994
2109,2021-05-19,73.79,602779,322617,276970,557132,1759498,2022,945,39,40,3046
2110,2021-05-20,73.53,425119,205648,58717,278188,967672,1577,673,32,30,2312
2111,2021-05-21,73.5975,443186,223563,63452,283075,1013276,1707,801,34,36,2578
2112,2021-05-24,73.4925,451118,233801,69065,286382,1040366,1748,855,33,36,2672
2113,2021-05-25,73.5,462078,244945,69565,286698,1063286,1797,868,34,37,2736
2114,2021-05-26,73.51,466227,249117,70061,287171,1072576,1816,884,34,37,2771
2115,2021-05-27,73.465,448322,233063,69104,284363,1034852,1683,732,34,31,2480
2116,2021-05-28,73.15,461620,251061,80787,291346,1084814,1796,830,35,36,2697
2117,2021-05-31,73.43,468582,259090,83705,293197,1104574,1828,863,35,35,2761
2118,2021-06-01,73.5075,470192,263027,85047,292212,1110478,1832,902,35,35,2804
2119,2021-06-02,73.16,484481,270292,85920,300109,1140802,1869,908,35,36,2848
2120,2021-06-03,73.24,473920,260065,85045,298900,1117930,1748,758,34,30,2570
2121,2021-06-04,72.795,491601,277397,90275,304479,1163752,1815,839,34,33,2721
2122,2021-06-07,72.81,500181,283859,91528,307850,1183418,1866,883,34,34,2817
2123,2021-06-08,72.3,512613,292302,91842,312153,1208910,1914,890,36,36,2876
2124,2021-06-09,72.305,529964,305143,93714,318535,1247356,1990,886,35,36,2947
2125,2021-06-10,71.77,521085,297286,94172,317971,1230514,1894,772,34,33,2733
2126,2021-06-11,72.13,542644,314670,101042,329016,1287372,1943,861,36,37,2877
2127,2021-06-14,72.1025,547961,321852,101705,327814,1299332,1967,904,34,37,2942
2128,2021-06-15,72.18,559388,332713,103074,329749,1324924,1987,899,35,37,2958
2129,2021-06-16,72.5625,575419,339085,103382,339716,1357602,2037,906,34,38,3015
2130,2021-06-17,72.3225,99369,99152,25489,25706,249716,988,507,19,19,1533
2131,2021-06-18,72.85,117805,120172,29235,26868,294080,1080,622,20,19,1741
2132,2021-06-21,73.1325,131403,135537,31138,27004,325082,1132,697,22,22,1873
2133,2021-06-22,72.875,134908,139559,32130,27479,334076,1166,740,22,22,1950
2134,2021-06-23,72.6075,143740,146774,33428,30394,354336,1261,757,23,22,2063
2135,2021-06-24,72.305,127131,125930,33806,35007,321874,1183,604,19,21,1827
2136,2021-06-25,72.2025,144799,141179,36629,40249,362856,1268,700,20,22,2010
2137,2021-06-28,72.1175,168629,155220,55465,68874,448188,1344,722,24,23,2113
2138,2021-06-29,72.76,176329,163906,76403,88826,505464,1345,784,25,25,2179
2139,2021-06-30,73.135,189211,177299,79616,91528,537654,1327,801,25,25,2178
2140,2021-07-01,73.4,181219,169128,83087,95178,528612,1206,692,26,25,1949
2141,2021-07-02,73.24,198434,180544,90772,108662,578412,1266,756,25,25,2072
2142,2021-07-05,73.46,203339,187593,93152,108898,592982,1292,783,25,25,2125
2143,2021-07-06,74.4225,220033,203855,99649,115827,639364,1236,821,26,25,2108
2144,2021-07-07,74.7125,239615,215689,108400,132326,696030,1230,832,26,28,2116
2145,2021-07-08,74.7375,235125,205804,118705,148026,707660,1111,731,24,27,1893
2146,2021-07-09,74.36,255677,234589,128269,149357,767892,1208,799,25,25,2057
2147,2021-07-12,74.44,257879,238644,126472,145707,768702,1245,822,25,25,2117
2148,2021-07-13,74.295,314069,255379,128642,187332,885422,1276,834,25,24,2159
2149,2021-07-14,74.075,322144,259754,126474,188864,897236,1304,832,25,24,2185
2150,2021-07-15,74.365,237953,187311,109653,160295,695212,1030,606,25,23,1684
2151,2021-07-16,74.0725,264340,212196,108986,161130,746652,1147,732,25,24,1928
2152,2021-07-19,74.65,277296,226028,111274,162542,777140,1176,793,25,25,2019
2153,2021-07-20,74.37,281878,231607,112538,162809,788832,1223,822,25,25,2095
2154,2021-07-21,74.015,285378,233641,112914,164651,796584,1274,829,25,24,2152
2155,2021-07-22,73.7,252801,199784,110044,163061,725690,1157,680,24,24,1885
2156,2021-07-23,73.76,275736,221637,110214,164313,771900,1252,765,26,24,2067
2157,2021-07-26,73.65,276307,224550,112947,164704,778508,1293,802,27,25,2147
2158,2021-07-27,73.7325,279402,228030,113241,164613,785286,1325,809,28,25,2187
2159,2021-07-28,73.4775,322735,244711,115221,193245,875912,1363,820,27,25,2235
2160,2021-07-29,73.1525,299667,225023,121262,195906,841858,1255,686,25,26,1992
2161,2021-07-30,73.16,328860,244909,121348,205299,900416,1405,786,25,29,2245
2162,2021-08-02,73.0575,348635,252072,114818,211381,926906,1478,818,26,29,2351
2163,2021-08-03,72.94,358212,260333,115496,213375,947416,1481,845,27,27,2380
2164,2021-08-04,73.17,378472,271709,117202,223965,991348,1493,850,28,29,2400
2165,2021-08-05,73.07,362004,260747,119085,220342,962178,1397,732,26,27,2182
2166,2021-08-06,73.49,377257,276029,152717,253945,1059948,1443,839,30,29,2341
2167,2021-08-09,73.665,392836,279290,151624,265170,1088920,1483,891,30,29,2433
2168,2021-08-10,73.9175,397804,286052,156414,268166,1108436,1437,907,29,30,2403
2169,2021-08-11,73.365,403700,288771,159479,274408,1126358,1470,910,29,34,2443
2170,2021-08-12,73.5925,395756,286829,163067,271994,1117646,1396,796,29,30,2251
2171,2021-08-13,73.21,414056,300578,166211,279689,1160534,1444,858,28,30,2360
2172,2021-08-16,73.2375,425838,308911,163847,280774,1179370,1461,875,29,31,2396
2173,2021-08-17,73.57,448545,311846,156689,293388,1210468,1460,883,29,31,2403
2174,2021-08-18,73.82,459511,314868,159473,304116,1237968,1463,896,31,33,2423
2175,2021-08-19,74.2,373593,241596,132268,264265,1011722,1154,682,31,30,1897
2176,2021-08-20,74.26,392655,252788,132004,271871,1049318,1189,764,30,31,2014
2177,2021-08-23,74.1225,400081,257797,132402,274686,1064966,1240,775,30,31,2076
2178,2021-08-24,73.73,422780,278437,133653,277996,1112866,1494,792,30,31,2347
2179,2021-08-25,73.9325,435868,291831,135765,279802,1143266,1430,808,30,32,2300
2180,2021-08-26,74.23,420507,278054,134237,276690,1109488,1278,719,29,30,2056
2181,2021-08-27,73.53,436224,302089,145942,280077,1164332,1399,791,30,30,2250
2182,2021-08-30,73.5,449864,313817,146765,282812,1193258,1453,816,30,29,2328
2183,2021-08-31,73.2175,477094,330959,161840,307975,1277868,1528,833,30,30,2421
2184,2021-09-01,72.98,488422,344932,165766,309256,1308376,1538,830,30,31,2429
2185,2021-09-02,72.87,463923,319649,168010,312284,1263866,1432,724,30,30,2216
2186,2021-09-03,72.7225,491696,346160,168496,314032,1320384,1525,816,33,35,2409
2187,2021-09-06,72.99,496444,355989,168982,309437,1330852,1540,845,35,37,2457
2188,2021-09-07,73.2725,503239,359358,169522,313403,1345522,1534,881,35,37,2487
2189,2021-09-08,73.1475,511626,355863,167672,323435,1358596,1513,900,34,37,2484
2190,2021-09-09,72.975,507546,340524,162364,329386,1339820,1424,783,34,33,2274
2191,2021-09-10,73.175,525108,357389,162172,329891,1374560,1479,879,35,37,2430
2192,2021-09-13,72.655,555756,370012,163042,348786,1437596,1532,901,35,36,2504
2193,2021-09-14,72.9,569780,377693,165197,357284,1469954,1532,917,35,37,2521
2194,2021-09-15,72.275,578911,381686,163735,360960,1485292,1543,895,35,37,2510
2195,2021-09-16,72.5,176653,131919,92057,136791,537420,903,528,25,26,1482
2196,2021-09-17,72.8525,219604,168700,108021,158925,655250,1014,651,25,26,1716
2197,2021-09-20,73.425,256110,197092,120658,179676,753536,1041,740,26,26,1833
2198,2021-09-21,73.085,263354,204140,120813,180027,768334,1101,768,26,26,1921
2199,2021-09-22,72.9725,274169,215900,128341,186610,805020,1193,792,29,26,2040
2200,2021-09-23,72.8425,253690,193938,130405,190157,768190,1074,653,28,26,1781
2201,2021-09-24,72.7225,268933,204893,132822,196862,803510,1174,764,28,26,1992
2202,2021-09-27,72.53,296917,220366,136481,213032,866796,1281,782,27,27,2117
2203,2021-09-28,72.795,317189,234480,139072,221781,912522,1317,807,28,27,2179
2204,2021-09-29,72.84,328744,246190,164840,247394,987168,1380,816,28,27,2251
2205,2021-09-30,72.735,321760,237945,171070,254885,985660,1274,682,28,27,2011
2206,2021-10-01,72.73,347404,252576,173638,268466,1042084,1368,790,28,30,2216
2207,2021-10-04,72.51,362646,263351,175397,274692,1076086,1437,811,29,31,2308
2208,2021-10-05,72.37,371851,275262,179007,275596,1101716,1465,833,29,31,2358
2209,2021-10-06,72.39,385512,298503,191111,278120,1153246,1486,841,30,31,2388
2210,2021-10-07,71.7,366941,285026,171328,253243,1076538,1400,713,31,31,2175
2211,2021-10-08,71.875,391391,301187,166200,256404,1115182,1476,803,31,34,2344
2212,2021-10-11,71.865,407399,311542,161071,256928,1136940,1549,824,31,33,2437
2213,2021-10-12,71.805,413445,315593,161756,259608,1150402,1574,845,31,33,2483
2214,2021-10-13,71.97,422245,318547,167087,270785,1178664,1600,850,32,33,2515
2215,2021-10-14,71.345,409220,312964,173582,269838,1165604,1515,727,31,30,2303
2216,2021-10-15,71.025,434086,335703,173167,271550,1214506,1627,807,32,33,2499
2217,2021-10-18,71.2875,444492,345596,177330,276226,1243644,1639,839,32,33,2543
2218,2021-10-19,70.8525,456306,358655,181499,279150,1275610,1653,842,33,33,2561
2219,2021-10-20,70.8025,464891,372103,195536,288324,1320854,1660,863,32,33,2588
2220,2021-10-21,71.095,336856,269628,151170,218398,976052,1253,584,31,28,1896
2221,2021-10-22,70.3375,375952,318097,163717,221572,1079338,1452,744,32,32,2260
2222,2021-10-25,69.71,396069,335241,184088,244916,1160314,1528,800,33,32,2393
2223,2021-10-26,69.5025,426707,354757,199733,271683,1252880,1619,821,33,33,2506
2224,2021-10-27,70.6425,446567,364032,209106,291641,1311346,1583,872,33,35,2523
2225,2021-10-28,70.2025,409437,328448,191812,272801,1202498,1484,703,33,29,2249
2226,2021-10-29,70.955,433716,347831,201149,287034,1269730,1540,841,33,35,2449
2227,2021-11-01,71.56,455558,367554,194354,282358,1299824,1562,902,32,35,2531
2228,2021-11-02,71.5025,462330,368579,196823,290574,1318306,1540,939,32,34,2545
2229,2021-11-03,71.73,448070,337873,191580,301777,1279300,1456,780,31,28,2295
2230,2021-11-05,71.255,471387,357650,193969,307706,1330712,1582,856,31,32,2501
2231,2021-11-08,71.2025,487087,371723,216514,331878,1407202,1639,877,31,32,2579
2232,2021-11-09,70.755,492629,381680,225882,336831,1437022,1704,893,31,32,2660
2233,2021-11-10,71.3,504679,397470,243449,350658,1496256,1755,908,33,32,2728
2234,2021-11-11,71.63,480130,370485,240792,350437,1441844,1619,808,34,28,2489
2235,2021-11-12,72.8875,493162,386643,253177,359696,1492678,1540,937,34,33,2544
2236,2021-11-15,72.5,501397,397483,277953,381867,1558700,1594,1003,34,33,2664
2237,2021-11-16,73.13,514202,408340,276660,382522,1581724,1554,1024,34,34,2646
2238,2021-11-17,72.5,528377,413188,284240,399429,1625234,1598,1030,34,36,2698
2239,2021-11-18,73.05,402850,294925,177296,285221,1160292,1375,744,33,30,2182
2240,2021-11-19,73.445,425938,327263,198441,297116,1248758,1419,891,33,32,2375
2241,2021-11-22,74.82,463852,350730,207321,320443,1342346,1341,962,32,32,2367
2242,2021-11-23,74.27,478413,363172,208749,323990,1374324,1362,989,33,32,2416
2243,2021-11-24,74.99,484087,374649,219480,328918,1407134,1394,998,33,32,2457
2244,2021-11-25,74.68,455180,346554,193996,302622,1298352,1295,808,33,28,2164
2245,2021-11-26,75.605,472874,362780,196618,306712,1338984,1372,926,33,32,2363
2246,2021-11-29,74.6,588042,380113,213832,421761,1603748,1452,952,34,32,2470
2247,2021-11-30,74.065,621353,440410,228195,409138,1699096,1513,992,33,32,2570
2248,2021-12-01,74.2775,652091,454530,235304,432865,1774790,1579,995,33,32,2639
2249,2021-12-02,73.64,645423,428463,190223,407183,1671292,1448,823,33,32,2336
2250,2021-12-03,73.8325,675354,464034,207855,419175,1766418,1541,939,34,35,2549
2251,2021-12-06,74.31,689574,471775,205576,423375,1790300,1613,982,34,37,2666
2252,2021-12-07,74.06,689361,486650,228365,431076,1835452,1577,1029,34,37,2677
2253,2021-12-08,73.5875,696888,481767,225407,440528,1844590,1631,1029,34,38,2732
2254,2021-12-09,73.685,675614,445885,210678,440407,1772584,1495,877,35,34,2441
2255,2021-12-10,73.3725,692692,462872,222986,452806,1831356,1598,951,34,38,2621
2256,2021-12-13,73.4975,711143,476455,226020,460708,1874326,1655,983,34,39,2711
2257,2021-12-14,73.8,716162,477323,226782,465621,1885888,1671,999,34,38,2742
2258,2021-12-15,73.71,719155,477109,224159,466205,1886628,1673,1007,35,39,2754
2259,2021-12-16,73.7525,131900,142309,78278,67869,420356,729,502,23,23,1277
2260,2021-12-17,74.13,150595,164643,91023,76975,483236,835,638,22,22,1517
2261,2021-12-20,74.145,163528,182650,102900,83778,532856,899,733,22,22,1676
2262,2021-12-21,73.9525,170263,189934,118060,98389,576646,957,763,22,22,1764
2263,2021-12-22,73.74,219564,203470,126326,142420,691780,1019,782,22,21,1844
2264,2021-12-23,73.3,201103,183361,171097,188839,744400,920,580,23,21,1544
2265,2021-12-24,73.65,227041,221280,201671,207432,857424,999,746,23,22,1790
2266,2021-12-27,73.4325,228932,243152,226422,212202,910708,1028,792,23,24,1867
2267,2021-12-28,73.7175,233469,257387,246820,222902,960578,1032,817,23,24,1896
2268,2021-12-29,73.9925,238588,293793,308506,253301,1094188,1022,838,23,26,1909
2269,2021-12-30,74.68,240364,235316,281784,286832,1044296,861,649,24,26,1560
2270,2022-01-03,74.5425,259325,253656,282166,287835,1082982,944,713,24,25,1706
2271,2022-01-04,75.3625,267961,268485,288280,287756,1112482,940,775,24,25,1764
2272,2022-01-05,76.8,274587,275171,288759,288175,1126692,966,819,25,26,1836
2273,2022-01-06,76.3175,271072,264343,286237,292966,1114618,875,737,25,31,1668
2274,2022-01-07,75.75,276510,277151,294211,293570,1141442,962,789,25,32,1808
2275,2022-01-10,75.0,285086,291236,299768,293618,1169708,1062,855,25,32,1974
2276,2022-01-11,74.45,293681,317064,315342,291959,1218046,1136,886,25,32,2079
2277,2022-01-12,74.7075,301594,328753,321420,294261,1246028,1204,915,26,32,2177
2278,2022-01-13,76.2575,275863,294117,310579,292325,1172884,957,836,26,30,1849
2279,2022-01-14,76.21,303831,321451,314541,296921,1236744,1017,928,27,34,2006
2280,2022-01-17,76.0925,316499,331972,314111,298638,1261220,1060,956,30,35,2081
2281,2022-01-18,76.91,324193,340173,315659,299679,1279704,1109,968,30,35,2142
2282,2022-01-19,76.1775,329206,345663,316277,299820,1290966,1089,984,29,35,2137
2283,2022-01-20,76.6825,224452,145475,87279,166256,623462,819,583,20,27,1449
2284,2022-01-21,77.425,257209,201879,117147,172477,748712,935,784,22,33,1774
2285,2022-01-24,78.7625,275005,217773,119773,177005,789556,977,853,22,34,1886
2286,2022-01-25,78.6325,284968,221793,123346,186521,816628,1052,893,22,34,2001
2287,2022-01-26,79.4175,300515,241640,127807,186682,856644,1082,919,23,34,2058
2288,2022-01-27,77.96,266503,178614,100727,188616,734460,946,685,20,29,1680
2289,2022-01-28,77.8,285955,205641,116044,196358,803998,1069,821,22,33,1945
2290,2022-01-31,77.315,290798,210934,116196,196060,813988,1151,848,21,32,2052
2291,2022-02-01,76.805,305278,235355,128894,198817,868344,1221,882,23,32,2158
2292,2022-02-02,76.04,319819,247171,131638,204286,902914,1327,907,24,33,2291
2293,2022-02-03,76.4475,287122,210601,113563,190084,801370,1093,748,24,30,1895
2294,2022-02-04,75.83,298057,230810,122999,190246,842112,1208,899,25,35,2167
2295,2022-02-07,75.475,312043,241129,123103,194017,870292,1308,939,25,37,2309
2296,2022-02-08,75.0075,331716,258514,124283,197485,911998,1357,954,26,39,2376
2297,2022-02-09,74.74,349386,281275,130558,198669,959888,1441,976,26,39,2482
2298,2022-02-10,75.01,341594,268356,119984,193222,923156,1326,796,22,30,2174
2299,2022-02-11,77.1675,356367,283675,129903,202595,972540,1358,951,21,34,2364
2300,2022-02-14,76.76,362128,288481,130265,203912,984786,1338,1023,22,34,2417
2301,2022-02-15,75.3125,369970,301072,172820,241718,1085580,1400,1048,23,33,2504
2302,2022-02-16,75.2525,380785,311203,179620,249202,1120810,1474,1062,23,36,2595
2303,2022-02-17,76.2825,313822,237197,155033,231658,937710,1066,708,20,30,1824
2304,2022-02-18,77.3,333865,272001,175209,237073,1018148,1222,912,22,33,2189
2305,2022-02-21,79.78,347085,286235,253607,314457,1201384,1189,1002,22,35,2248
2306,2022-02-22,78.8,344708,284537,246495,306666,1182406,1232,1011,21,36,2300
2307,2022-02-23,81.16,354208,299605,259518,314121,1227452,1221,1040,22,37,2320
2308,2022-02-24,85.25,307823,239954,237077,304946,1089800,966,734,20,27,1747
2309,2022-02-25,83.0,304692,237703,239656,306645,1088696,1049,751,23,27,1850
2310,2022-02-28,94.6025,305817,240114,244388,310091,1100410,1085,770,22,29,1906
2311,2022-03-01,101.2325,305817,240114,244388,310091,1100410,1085,770,22,29,1906
2312,2022-03-02,106.02,236689,221533,242393,257549,958164,906,705,21,28,1660
2313,2022-03-03,106.01,205891,209380,231580,228091,874942,708,585,20,25,1338
2314,2022-03-04,105.0,202420,205881,231090,227629,867020,688,575,19,25,1307
2315,2022-03-09,120.0,201679,202064,231011,230626,865380,719,588,19,26,1352
2316,2022-03-10,118.5,206221,194847,202982,214356,818406,731,576,19,27,1353
2317,2022-03-11,114.2525,206647,194328,201975,214294,817244,755,595,17,27,1394
2318,2022-03-14,114.1025,205924,187525,154756,173155,721360,766,617,17,27,1427
2319,2022-03-15,110.1,206105,187785,144597,162917,701404,751,613,17,27,1408
2320,2022-03-16,108.0,209586,176134,80861,114313,580894,761,622,17,27,1427
2321,2022-03-17,103.15,51085,52575,39829,38339,181828,192,169,8,14,383
2322,2022-03-18,104.82,55779,53993,39889,41675,191336,263,204,9,16,492
2323,2022-03-21,104.0,57641,55296,39889,42234,195060,336,253,9,19,617
2324,2022-03-22,103.55,58328,52192,39889,46025,196434,360,278,9,19,666
2325,2022-03-23,97.7375,63109,54429,39889,48569,205996,405,298,9,19,731
2326,2022-03-24,97.0,59009,50945,28389,36453,174796,283,213,8,17,521
2327,2022-03-25,96.0,62740,55342,29389,36787,184258,383,279,9,17,688
2328,2022-03-28,89.75,70030,58466,29389,40953,198838,478,305,9,18,810
2329,2022-03-29,85.25,96991,65580,9141,40552,212264,627,359,7,18,1011
2330,2022-03-30,84.55,101736,70309,9047,40474,221566,762,411,6,18,1197
2331,2022-03-31,83.2,92200,59914,8047,40333,200494,648,315,5,15,983
2332,2022-04-01,83.95,98102,62904,8157,43355,212518,765,407,6,18,1196
2333,2022-04-04,84.0,101277,64352,9417,46342,221388,838,438,6,19,1301
2334,2022-04-05,83.3125,97819,60737,10138,47220,215914,882,478,7,20,1387
2335,2022-04-06,79.7,101872,63931,10148,48089,224040,943,481,8,20,1452
2336,2022-04-07,75.75,100155,63695,10604,47064,221518,939,389,9,17,1354
2337,2022-04-08,76.08,111831,74664,11117,48284,245896,1153,473,11,20,1657
2338,2022-04-11,79.065,114723,77332,11185,48576,251816,1198,527,11,22,1758
2339,2022-04-12,79.68,118465,77931,11160,51694,259250,1199,555,11,22,1787
2340,2022-04-13,79.8675,120937,80903,11664,51698,265202,1202,574,14,23,1813
2341,2022-04-14,80.8975,109684,70045,11624,51263,242616,1031,445,12,21,1509
2342,2022-04-15,79.995,113330,75805,14118,51643,254896,1090,513,13,22,1638
2343,2022-04-18,79.75,116973,79134,14174,52013,262294,1126,532,12,22,1692
2344,2022-04-19,78.515,120143,82062,14176,52257,268638,1126,541,12,22,1701
2345,2022-04-20,76.4125,128603,89099,14160,53664,285526,1185,545,13,22,1765
2346,2022-04-21,74.785,78287,56690,12749,34346,182072,858,376,8,13,1255
2347,2022-04-22,75.45,91081,70631,14014,34464,210190,999,501,8,16,1524
2348,2022-04-25,73.125,98079,77497,14026,34608,224210,1159,535,9,16,1719
2349,2022-04-26,73.525,103686,79674,14059,38071,235490,1222,546,11,18,1797
2350,2022-04-27,72.78,106186,83745,16182,38623,244736,1249,575,11,18,1853
2351,2022-04-28,72.08,92959,70322,16071,38708,218060,1031,451,9,15,1506
2352,2022-04-29,70.96,104361,82587,17134,38908,242990,1187,543,10,15,1755
2353,2022-05-04,66.3,114467,92833,17348,38982,263630,1318,585,10,15,1928
2354,2022-05-05,67.0,109227,88009,17351,38569,253156,1250,504,10,14,1778
2355,2022-05-06,69.4025,118758,97056,17801,39503,273118,1334,613,9,16,1972
2356,2022-05-11,67.2,129616,105548,18047,42115,295326,1409,647,10,18,2084
2357,2022-05-12,63.3,135281,104307,14001,44975,298564,1365,547,10,17,1939
2358,2022-05-13,64.545,147224,116067,14040,45197,322528,1449,652,11,22,2134
2359,2022-05-16,63.4,150548,118120,14038,46466,329172,1541,672,11,22,2246
2360,2022-05-17,63.6,151830,119346,14027,46511,331714,1567,687,11,24,2289
2361,2022-05-18,63.445,153428,120849,14004,46583,334864,1570,710,11,24,2315
2362,2022-05-19,61.905,129391,98126,16540,47805,291862,1240,506,10,17,1773
2363,2022-05-20,60.2325,146689,115158,16914,48445,327206,1450,632,13,22,2117
2364,2022-05-23,57.8675,156202,126399,19156,48959,350716,1663,656,12,22,2353
2365,2022-05-24,56.8,164727,136153,21257,49831,371968,1746,675,13,22,2456
2366,2022-05-25,59.33,182765,152070,21377,52072,408284,1742,726,13,22,2503
2367,2022-05-26,65.26,162735,136011,25018,51742,375506,1396,638,12,18,2064
2368,2022-05-27,66.7,180690,153522,24999,52167,411378,1436,785,13,19,2253
2369,2022-05-30,62.25,203718,165424,25201,63495,457838,1738,816,15,21,2590
2370,2022-05-31,61.5,211574,172409,26158,65323,475464,1827,838,15,21,2701
2371,2022-06-01,61.28,215360,176134,26337,65563,483394,1880,871,15,21,2787
2372,2022-06-02,61.65,193023,149770,26265,69518,438576,1589,718,15,21,2343
2373,2022-06-03,60.95,198966,155086,26333,70213,450598,1715,805,16,23,2559
2374,2022-06-06,61.0175,201930,157957,26371,70344,456602,1759,821,17,23,2620
2375,2022-06-07,61.0425,206008,161915,26561,70654,465138,1758,846,17,24,2645
2376,2022-06-08,59.4,213735,168807,26623,71551,480716,1795,840,18,24,2677
2377,2022-06-09,59.35,206080,165052,29125,70153,470410,1680,702,20,23,2425
2378,2022-06-10,56.8,227524,185267,29646,71903,514340,1900,741,19,23,2683
2379,2022-06-14,56.6,240321,196566,29059,72814,538760,1889,774,19,23,2705
2380,2022-06-15,56.96,250060,204443,30024,75641,560168,1893,767,18,24,2702
2381,2022-06-16,56.5,52799,43507,19843,29135,145284,742,419,8,13,1182
2382,2022-06-17,56.41,61149,49804,20084,31429,162466,919,539,9,17,1484
2383,2022-06-20,55.63,67525,56496,20678,31707,176406,1047,578,10,18,1653
2384,2022-06-21,53.775,80074,66906,20803,33971,201754,1145,610,9,18,1782
2385,2022-06-22,53.15,94484,78235,20883,37132,230734,1255,636,10,18,1919
2386,2022-06-23,53.465,70876,55738,20620,35758,182992,1011,492,9,16,1528
2387,2022-06-24,53.4,81465,64398,21293,38360,205516,1155,594,12,17,1778
2388,2022-06-27,53.385,89405,72793,21826,38438,222462,1259,626,11,17,1913
2389,2022-06-28,51.8,103643,88114,23883,39412,255052,1378,637,11,18,2044
2390,2022-06-29,53.2375,120338,103803,23156,39691,286988,1490,688,10,19,2207
2391,2022-06-30,51.45,92659,86549,26111,32221,237540,1237,560,9,17,1823
2392,2022-07-01,54.5,107461,95951,24687,36197,264296,1279,707,10,19,2015
2393,2022-07-04,55.24,121434,108827,24843,37450,292554,1416,732,12,21,2181
2394,2022-07-05,61.15,144233,128282,24146,40097,336758,1262,800,13,23,2098
2395,2022-07-06,63.35,139807,125547,24771,39031,329156,1323,830,14,25,2192
2396,2022-07-07,61.95,105747,92162,24528,38113,260550,1153,619,14,24,1810
2397,2022-07-08,60.92,114209,100726,24854,38337,278126,1283,729,16,26,2054
2398,2022-07-11,58.9,123935,109394,25079,39620,298028,1387,745,17,27,2176
2399,2022-07-12,58.94,135660,117572,25027,43115,321374,1492,768,16,27,2303
2400,2022-07-13,58.27,139828,122456,25414,42786,330484,1528,789,17,27,2361
2401,2022-07-14,58.3,120084,102885,25229,42428,290626,1251,666,15,25,1957
2402,2022-07-15,57.165,128072,108474,25313,44911,306770,1436,757,17,28,2238
2403,2022-07-18,56.34,132433,112315,25290,45408,315446,1516,793,18,28,2355
2404,2022-07-19,55.4525,142141,121992,25524,45673,335330,1628,792,20,29,2469
2405,2022-07-20,55.02,148309,127373,25556,46492,347730,1715,806,19,28,2568
2406,2022-07-21,56.6475,104310,91539,18604,31375,245828,1251,609,14,22,1896
2407,2022-07-22,57.29,122223,105399,18689,35513,281824,1451,753,15,25,2244
2408,2022-07-25,58.11,132098,111464,20285,40919,304766,1528,806,17,26,2377
2409,2022-07-26,60.55,142845,118874,21533,45504,328756,1506,861,17,26,2410
2410,2022-07-27,59.88,149322,125869,22342,45795,343328,1603,888,19,29,2539
2411,2022-07-28,60.82,123029,104060,22333,41302,290724,1330,671,17,27,2045
2412,2022-07-29,61.62,133123,112179,22946,43890,312138,1482,827,20,29,2358
2413,2022-08-01,60.17,143825,120810,22091,45106,331832,1653,853,21,29,2556
2414,2022-08-02,60.295,149032,125951,22188,45269,342440,1733,871,21,30,2655
2415,2022-08-03,60.58,169634,137976,22624,54282,384516,1734,905,21,29,2689
2416,2022-08-04,60.35,142748,110450,21448,53746,328392,1424,727,19,27,2197
2417,2022-08-05,60.58,155088,119614,21980,57454,354136,1595,851,21,30,2497
2418,2022-08-08,60.755,161345,123876,22484,59953,367658,1666,901,20,30,2617
2419,2022-08-09,60.1475,167230,129549,22563,60244,379586,1737,920,21,30,2708
2420,2022-08-10,60.665,172627,131849,22571,63349,390396,1772,930,20,29,2751
2421,2022-08-11,60.67,148048,114466,22114,55696,340324,1515,780,18,27,2340
2422,2022-08-12,60.605,158031,122539,22562,58054,361186,1673,885,19,28,2605
2423,2022-08-15,61.225,166872,128268,23492,62096,380728,1671,958,19,28,2676
2424,2022-08-16,60.9,171290,132282,25452,64460,393484,1705,964,20,29,2718
2425,2022-08-17,60.75,179796,140105,26734,66425,413060,1739,962,20,29,2750
2426,2022-08-18,59.5325,150741,117249,26601,60093,354684,1405,741,18,26,2190
2427,2022-08-19,59.1,157893,123947,26790,60736,369366,1571,844,19,27,2461
2428,2022-08-22,59.87,164582,130418,26637,60801,382438,1609,925,19,27,2580
2429,2022-08-23,59.89,168664,133776,26840,61728,391008,1650,949,19,27,2645
2430,2022-08-24,59.8875,176553,140866,26925,62612,406956,1708,968,19,27,2722
2431,2022-08-25,60.145,158405,125621,26434,59218,369678,1459,803,19,24,2305
2432,2022-08-26,60.5,167550,136745,29631,60436,394362,1598,918,20,27,2563
2433,2022-08-29,60.3975,175647,142359,31187,64475,413668,1681,963,20,26,2690
2434,2022-08-30,59.94,183019,154048,37412,66383,440862,1729,1003,19,26,2777
2435,2022-08-31,60.23,185614,157039,38525,67100,448278,1719,999,19,27,2764
2436,2022-09-01,60.31,170675,144053,39380,66002,420110,1504,820,17,26,2367
2437,2022-09-02,60.58,182480,152258,39491,69713,443942,1591,958,20,27,2596
2438,2022-09-05,60.87,189184,158658,39617,70143,457602,1699,992,20,28,2739
2439,2022-09-06,61.235,196346,162788,40796,74354,474284,1705,1006,21,29,2761
2440,2022-09-07,60.79,198857,165430,41042,74469,479798,1692,1009,21,29,2751
2441,2022-09-08,60.73,181339,151239,40441,70541,443560,1543,850,18,26,2437
2442,2022-09-09,60.6,186703,158689,43537,71551,460480,1615,930,19,26,2590
2443,2022-09-12,60.24,190162,166484,47552,71230,475428,1627,936,20,27,2610
2444,2022-09-13,59.9,190786,170124,50636,71298,482844,1648,937,21,27,2633
2445,2022-09-14,59.885,193344,172616,50660,71388,488008,1645,945,22,28,2640
2446,2022-09-15,59.8,52092,68129,24352,8315,152888,704,500,12,17,1233
2447,2022-09-16,60.275,79322,95303,36466,20485,231576,865,597,14,17,1493
2448,2022-09-19,60.16,92620,105725,36506,23401,258252,965,644,14,16,1639
2449,2022-09-20,60.6,111800,127581,39759,23978,303118,1007,682,15,17,1721
2450,2022-09-21,60.69,117670,134597,41822,24895,318984,1106,701,17,16,1840
2451,2022-09-22,58.84,98420,120103,44303,22620,285446,934,532,13,13,1492
2452,2022-09-23,57.92,133614,147628,48324,34310,363876,1157,664,13,13,1847
2453,2022-09-26,58.395,138016,151457,48416,34975,372864,1211,691,15,15,1932
2454,2022-09-27,58.4575,146561,158380,48556,36737,390234,1227,695,16,16,1954
2455,2022-09-28,57.54,157059,166159,48412,39312,410942,1256,693,17,16,1982
2456,2022-09-29,57.21,122875,139389,49399,32885,344548,1031,524,15,13,1583
2457,2022-09-30,58.45,147711,153483,50316,44544,396054,1153,616,19,15,1803
2458,2022-10-03,58.86,155724,159724,50683,46683,412814,1228,654,22,16,1920
2459,2022-10-04,58.95,160385,162643,50805,48547,422380,1257,677,21,16,1971
2460,2022-10-05,60.1725,168668,170050,50402,49020,438140,1225,711,21,16,1973
2461,2022-10-06,60.9025,132643,150001,48116,30758,361518,1044,566,17,13,1640
2462,2022-10-07,61.0025,153378,157637,48282,44023,403320,1220,661,20,14,1915
2463,2022-10-10,62.69,164162,161862,42718,45018,413760,1275,702,19,15,2011
2464,2022-10-11,63.66,166008,161282,42871,47597,417758,1316,713,19,16,2064
2465,2022-10-12,64.42,168447,163905,43155,47697,423204,1322,729,19,15,2085
2466,2022-10-13,63.63,149656,153231,42727,39152,384766,1102,593,16,12,1723
2467,2022-10-14,62.1075,163190,158007,42769,47952,411918,1209,660,16,13,1898
2468,2022-10-17,61.65,168576,163267,43029,48338,423210,1321,687,20,14,2042
2469,2022-10-18,61.575,170473,165226,43308,48555,427562,1338,730,20,14,2102
2470,2022-10-19,61.735,172216,166798,43249,48667,430930,1386,732,20,14,2152
2471,2022-10-20,61.4,124769,137324,43078,30523,335694,974,533,17,12,1536
2472,2022-10-21,61.29,131816,144322,43166,30660,349964,1088,673,18,13,1792
2473,2022-10-24,61.185,137269,155858,50811,32222,376160,1129,720,18,13,1880
2474,2022-10-25,61.4875,140032,158891,51080,32221,382224,1128,753,17,15,1913
2475,2022-10-26,61.75,144791,163260,51103,32634,391788,1178,765,17,16,1976
2476,2022-10-27,61.725,130435,150221,50869,31083,362608,985,595,16,14,1610
2477,2022-10-28,61.52,135881,155586,51048,31343,373858,1057,715,17,17,1806
2478,2022-10-31,61.4775,141216,159652,50953,32517,384338,1159,750,18,18,1945
2479,2022-11-01,61.2375,143544,163018,52123,32649,391334,1167,761,18,18,1964
2480,2022-11-02,61.8,148008,168313,52731,32426,401478,1162,784,18,18,1982
2481,2022-11-03,62.1,138021,158192,52052,31881,380146,1035,629,16,14,1694
2482,2022-11-07,61.0,147192,165035,52122,34279,398628,1167,729,18,18,1932
2483,2022-11-08,60.9925,150109,167604,52159,34664,404536,1199,749,18,18,1984
2484,2022-11-09,61.31,151520,172938,55054,33636,413148,1180,784,18,19,2001
2485,2022-11-10,60.53,144594,164032,53574,34136,396336,1098,642,17,13,1770
2486,2022-11-11,60.5375,150480,169521,53666,34625,408292,1177,737,18,15,1947
2487,2022-11-14,60.55,154007,173071,53706,34642,415426,1202,771,18,16,2007
2488,2022-11-15,60.4,159030,177806,53686,34910,425432,1228,785,18,16,2047
2489,2022-11-16,60.35,162477,181352,53643,34768,432240,1236,800,18,16,2070
2490,2022-11-17,60.53,142072,161741,53519,33850,391182,1002,598,16,14,1630
2491,2022-11-18,60.4025,150647,169439,54076,35284,409446,1094,750,18,20,1882
2492,2022-11-21,60.85,154681,173372,54409,35718,418180,1148,779,18,21,1966
2493,2022-11-22,60.6825,157771,175932,54346,36185,424234,1175,784,19,21,1999
2494,2022-11-23,60.7,161855,180426,54523,35952,432756,1165,813,18,21,2017
2495,2022-11-24,60.6725,149906,168941,53954,34919,407720,1050,639,16,14,1719
2496,2022-11-25,60.5025,175397,189401,75184,61180,501162,1110,723,20,19,1872
2497,2022-11-28,61.2275,177527,193598,77211,61140,509476,1149,761,20,19,1949
2498,2022-11-29,61.0225,182470,197164,76379,61685,517698,1192,773,20,20,2005
2499,2022-11-30,60.99,185286,199892,76565,61959,523702,1205,787,20,20,2032
2500,2022-11-30,60.99,185286,199892,76565,61959,523702,1205,787,20,20,2032
2501,2022-12-01,61.49,172156,186266,74984,60874,494280,1065,663,19,18,1765
2502,2022-12-02,62.0,183706,197848,75531,61389,518474,1118,778,20,19,1935
2503,2022-12-05,62.35,193478,207274,75636,61840,538228,1181,817,21,19,2038
2504,2022-12-06,63.085,195845,210223,76148,61770,543986,1186,841,21,19,2067
2505,2022-12-07,62.75,203855,217780,76716,62791,561142,1230,850,20,19,2119
2506,2022-12-08,62.7725,189696,204399,79987,65284,539366,1114,706,20,21,1861
2507,2022-12-09,62.43,196121,214980,84845,65986,561932,1191,776,21,21,2009
2508,2022-12-12,62.8,197928,216574,84930,66284,565716,1174,818,22,22,2036
2509,2022-12-13,62.85,201523,220252,87266,68537,577578,1196,836,24,22,2078
2510,2022-12-14,63.995,204619,221956,89840,72503,588918,1148,853,23,24,2048
2511,2022-12-15,64.3525,32926,26759,7725,13892,81302,479,396,14,12,901
2512,2022-12-16,64.65,45221,39380,8199,14040,106840,599,510,14,13,1136
2513,2022-12-19,67.72,57070,54845,10540,12765,135220,639,583,15,13,1250
2514,2022-12-20,68.875,75733,73925,12136,13944,175738,706,648,17,15,1386
2515,2022-12-21,70.995,85229,81871,12828,16186,196114,747,695,18,15,1475
2516,2022-12-22,68.95,69929,61998,10938,18869,161734,697,491,17,13,1218
2517,2022-12-23,70.2,87582,75657,11678,23603,198520,873,617,18,14,1522
2518,2022-12-26,69.29,99278,85308,12461,26431,223478,939,673,20,15,1647
2519,2022-12-27,70.4,102619,90912,15341,27048,235920,900,710,20,14,1644
2520,2022-12-28,72.19,113676,100479,22617,35814,272586,882,744,20,15,1661
2521,2022-12-29,72.175,93038,78565,21287,35760,228650,781,517,17,12,1327
2522,2022-12-30,69.9,106413,90809,21904,37508,256634,918,619,19,16,1572
2523,2023-01-03,71.1375,115107,99517,23369,38959,276952,913,657,19,16,1605
2524,2023-01-04,72.0,122315,105736,23101,39680,290832,946,685,19,16,1666
2525,2023-01-05,72.18,102732,85316,21735,39151,248934,847,562,17,14,1440
2526,2023-01-06,72.1225,113990,96074,21656,39572,271292,931,646,18,16,1611
2527,2023-01-09,69.99,126552,107029,21715,41238,296534,1091,675,21,16,1803
2528,2023-01-10,69.8,129537,110543,22509,41503,304092,1140,718,21,15,1894
2529,2023-01-11,68.7325,137445,116754,22536,43227,319962,1173,715,20,15,1923
2530,2023-01-12,67.7575,120715,100580,21867,42002,285164,1056,625,18,16,1715
2531,2023-01-13,68.7875,134274,112698,22141,43717,312830,1111,773,19,18,1921
2532,2023-01-16,68.43,139782,116054,20366,44094,320296,1181,801,20,20,2022
2533,2023-01-17,69.15,144923,119336,20364,45951,330574,1195,806,19,20,2040
2534,2023-01-18,68.7475,150675,122528,20321,48468,341992,1234,815,20,21,2090
2535,2023-01-19,68.8,106118,81730,16451,40839,245138,909,511,15,12,1447
2536,2023-01-20,68.83,116147,90439,16943,42651,266180,1025,640,16,18,1699
2537,2023-01-23,68.925,128216,100582,17435,45069,291302,1079,689,19,18,1805
2538,2023-01-24,69.0,134967,106689,17563,45841,305060,1122,716,19,18,1875
2539,2023-01-25,69.305,157701,130971,44494,71224,404390,1141,733,20,18,1912
2540,2023-01-26,69.265,150600,123898,53783,80485,408766,1001,578,19,14,1612
2541,2023-01-27,69.46,162060,136097,60587,86550,445294,1092,694,22,19,1827
2542,2023-01-30,70.405,173423,149992,66210,89641,479266,1114,755,21,19,1909
2543,2023-01-31,69.82,192555,167330,69054,94279,523218,1163,777,22,19,1981
2544,2023-02-01,70.1975,200852,164514,80290,116628,562284,1204,797,22,20,2043
2545,2023-02-02,70.455,161195,130764,96131,126562,514652,1053,625,20,15,1713
2546,2023-02-03,70.6,174641,142471,97879,130049,545040,1143,707,22,18,1890
2547,2023-02-06,70.95,184389,147964,98984,135409,566746,1175,729,23,20,1947
2548,2023-02-07,71.15,189022,151639,99802,137185,577648,1195,751,22,20,1988
2549,2023-02-08,72.3025,193364,155131,97292,135525,581312,1139,788,22,19,1968
2550,2023-02-09,73.0,194241,147912,101113,147442,590708,1058,666,21,17,1762
2551,2023-02-10,73.39,202522,155657,101221,148086,607486,1151,736,23,19,1929
2552,2023-02-13,73.825,209278,161642,101383,149019,621322,1200,777,23,19,2019
2553,2023-02-14,73.8,226197,175647,103081,153631,658556,1271,791,24,21,2107
2554,2023-02-15,74.5725,227124,177503,106209,155830,666666,1274,812,24,21,2131
2555,2023-02-16,74.855,165075,121415,88066,131726,506282,1036,623,22,14,1695
2556,2023-02-17,74.29,209336,164207,112716,157845,644104,1193,715,23,17,1948
2557,2023-02-20,74.5,232781,178464,116354,170671,698270,1182,751,26,18,1977
2558,2023-02-21,75.0475,243370,190885,116380,168865,719500,1224,761,26,18,2029
2559,2023-02-22,75.0,224511,171011,116848,170348,682718,1038,617,22,14,1691
2560,2023-02-24,76.13,235814,191086,122341,167069,716310,1102,717,24,16,1859
2561,2023-02-27,74.6025,256592,217012,136617,176197,786418,1228,746,23,19,2016
2562,2023-02-28,74.97,266379,222123,136282,180538,805322,1265,781,25,19,2090
2563,2023-03-01,75.15,264505,219604,135317,180218,799644,1236,793,24,21,2074
2564,2023-03-02,75.3175,240817,194522,135007,181302,751648,1077,691,21,17,1806
2565,2023-03-03,75.6325,249723,210593,138230,177360,775906,1141,790,23,21,1975
2566,2023-03-06,75.445,248539,211848,144330,181021,785738,1152,819,23,22,2016
2567,2023-03-07,76.0225,254918,203100,140280,192098,790396,1137,842,25,22,2026
2568,2023-03-09,75.845,239629,184167,140741,196203,760740,1040,727,23,19,1809
2569,2023-03-10,76.1,249670,194468,141488,196690,782316,1101,799,25,22,1947
2570,2023-03-13,75.0,274154,197630,150032,226556,848372,1136,799,26,22,1983
2571,2023-03-14,75.32,276402,196115,146731,227018,846266,1140,816,27,23,2006
2572,2023-03-15,75.985,287961,206265,146163,227859,868248,1140,837,26,22,2025
2573,2023-03-16,76.4,83114,65234,6675,24555,179578,531,469,12,13,1025
2574,2023-03-17,77.06,99846,76919,11402,34329,222496,628,559,13,14,1214
2575,2023-03-20,77.17,115558,92928,12818,35448,256752,682,601,13,16,1312
2576,2023-03-21,76.66,120845,98821,14186,36210,270062,718,618,14,16,1366
2577,2023-03-22,77.0575,125324,103923,14794,36195,280236,735,637,14,16,1402
2578,2023-03-23,76.0,92752,71436,12176,33492,209856,692,477,12,13,1194
2579,2023-03-24,77.075,113472,91555,12768,34685,252480,779,619,12,16,1426
2580,2023-03-27,76.68,124874,102599,12856,35131,275460,831,646,12,17,1506
2581,2023-03-28,76.9,129992,107931,13660,35721,287304,822,674,12,17,1525
2582,2023-03-29,77.155,132746,112586,16121,36281,297734,852,708,12,17,1589
2583,2023-03-30,77.08,105282,83973,12314,33623,235192,704,525,11,12,1252
2584,2023-03-31,77.5975,124789,103727,15378,36440,280334,802,641,13,15,1471
