,date_kotirovki,close,PhysicalLong,PhysicalShort,JuridicalLong,JuridicalShort,putov_summa,PhysicalLong_liza,PhysicalShort_liza,JuridicalLong_liza,JuridicalShort_liza,putov_summa_liza
0,2013-01-08,30.212,4647,6436,11235,9446,31764,139,122,17,32,310
1,2013-01-09,30.36,10068,12361,12046,9753,44228,149,129,20,34,332
2,2013-01-10,30.191,14050,16807,12400,9643,52900,160,131,19,37,347
3,2013-01-11,30.3145,14023,16840,12471,9654,52988,162,135,19,37,353
4,2013-01-14,30.254,16353,19326,12546,9573,57798,172,140,22,34,368
5,2013-01-15,30.3475,16461,19489,13602,10574,60126,173,151,23,35,382
6,2013-01-16,30.311,16825,20467,14480,10838,62610,176,159,26,35,396
7,2013-01-17,30.1945,19539,23695,14996,10840,69070,185,160,26,35,406
8,2013-01-18,30.27,20767,24899,15005,10873,71544,194,165,27,34,420
9,2013-01-21,30.268,22118,26028,14977,11067,74190,199,166,26,34,425
10,2013-01-22,30.225,22100,26018,14973,11055,74146,204,168,26,34,432
11,2013-01-23,30.162,22510,26222,14874,11162,74768,208,172,26,35,441
12,2013-01-24,30.0735,22511,26228,14880,11163,74782,209,177,26,36,448
13,2013-01-25,30.0325,22819,26526,15028,11321,75694,213,186,25,36,460
14,2013-01-28,30.1675,24263,27902,15504,11865,79534,221,192,26,39,478
15,2013-01-29,30.035,24386,28134,15530,11782,79832,225,194,26,39,484
16,2013-01-30,30.0175,24438,28425,15532,11545,79940,228,200,27,38,493
17,2013-01-31,30.026,24492,28464,15532,11560,80048,230,201,27,38,496
18,2013-02-01,29.86,24693,28567,15532,11658,80450,232,213,27,41,513
19,2013-02-04,30.0875,25547,29977,16099,11669,83292,247,214,28,41,530
20,2013-02-05,29.95,25358,30246,16947,12059,84610,246,226,31,40,543
21,2013-02-06,30.088,25572,30310,17909,13171,86962,259,229,32,41,561
22,2013-02-07,30.188,26098,30412,17920,13606,88036,261,231,31,41,564
23,2013-02-08,30.1745,26426,30727,17909,13608,88670,267,233,31,41,572
24,2013-02-11,30.165,26916,30909,18807,14814,91446,272,236,31,41,580
25,2013-02-12,30.04,27001,30975,18880,14906,91762,272,238,32,41,583
26,2013-02-13,30.056,26851,30791,19063,15123,91828,280,242,33,41,596
27,2013-02-14,30.1,26873,30811,19064,15126,91874,278,242,33,41,594
28,2013-02-15,30.134,26896,30832,19068,15132,91928,278,244,36,41,599
29,2013-02-18,30.134,26899,30842,19078,15135,91954,278,244,38,41,601
30,2013-02-19,30.076,26989,30969,19127,15147,92232,281,251,38,42,612
31,2013-02-20,30.1935,28625,31105,18262,15782,93774,288,257,37,44,626
32,2013-02-21,30.4865,29741,31065,18037,16713,95556,293,257,39,43,632
33,2013-02-22,30.4225,30294,33071,19493,16716,99574,297,263,39,43,642
34,2013-02-25,30.507,30660,33416,24590,21834,110500,300,262,40,43,645
35,2013-02-26,30.6345,33416,41695,31481,23202,129794,303,256,38,48,645
36,2013-02-27,30.5325,31131,43264,30948,18815,124158,308,257,38,46,649
37,2013-02-28,30.561,31273,43523,31085,18835,124716,309,259,38,46,652
38,2013-03-01,30.699,35022,51738,35047,18331,140138,315,259,42,47,663
39,2013-03-04,30.734,44596,68548,46202,22250,181596,320,267,43,49,679
40,2013-03-05,30.616,56102,81426,47681,22357,207566,322,272,44,50,688
41,2013-03-06,30.721,56229,81650,47680,22259,207818,326,273,43,50,692
42,2013-03-07,30.6975,56540,81943,47690,22287,208460,334,281,44,51,710
43,2013-03-11,30.7175,53365,74026,47841,27180,202412,338,287,44,52,721
44,2013-03-12,30.701,54296,74158,46932,27070,202456,349,292,44,52,737
45,2013-03-13,30.794,54317,74609,47149,26857,202932,356,289,46,50,741
46,2013-03-14,30.72,54262,74814,47411,26859,203346,361,288,46,51,746
47,2013-03-15,30.657,2237,1561,1447,2123,7368,47,61,8,13,129
48,2013-03-18,30.835,5496,2585,4869,7780,20730,87,81,9,18,195
49,2013-03-19,30.9855,5784,2935,5007,7856,21582,96,91,11,19,217
50,2013-03-20,30.85,8341,3827,8222,12736,33126,113,99,15,19,246
51,2013-03-21,30.9345,8461,3999,8252,12714,33426,118,108,15,20,261
52,2013-03-22,30.837,8880,4656,14415,18639,46590,122,115,19,22,278
53,2013-03-25,30.924,9662,5907,15669,19424,50662,132,128,22,27,309
54,2013-03-26,30.852,9468,5553,15832,19747,50600,129,132,22,27,310
55,2013-03-27,31.04,9758,5623,15612,19747,50740,135,135,22,27,319
56,2013-03-28,31.0965,9909,6033,16024,19900,51866,141,142,23,28,334
57,2013-03-29,31.06,11620,7949,16199,19870,55638,151,148,25,28,352
58,2013-04-01,31.0845,12642,9227,16456,19871,58196,156,150,25,28,359
59,2013-04-02,31.3205,13265,9761,16367,19871,59264,157,154,26,28,365
60,2013-04-03,31.644,15119,15283,22807,22643,75852,170,171,26,35,402
61,2013-04-04,31.585,13896,17774,20024,16146,67840,188,184,25,37,434
62,2013-04-05,31.52,15201,19181,20146,16166,70694,193,193,25,37,448
63,2013-04-08,31.2195,15760,19616,19978,16122,71476,186,214,27,38,465
64,2013-04-09,31.0205,15879,17567,22405,20717,76568,184,215,30,46,475
65,2013-04-10,30.884,19981,16937,23602,26646,87166,187,224,33,46,490
66,2013-04-11,30.884,20600,17550,23596,26646,88392,185,230,33,46,494
67,2013-04-12,31.085,20727,17307,23251,26671,87956,186,235,34,46,501
68,2013-04-15,31.45,18287,18198,22318,22407,81210,189,231,35,45,500
69,2013-04-16,31.263,17297,20951,20797,17143,76188,194,232,35,40,501
70,2013-04-17,31.886,17687,21058,20651,17280,76676,214,233,38,38,523
71,2013-04-18,31.55,18525,20706,22634,20453,82318,217,231,36,41,525
72,2013-04-19,31.6635,18635,20865,22687,20457,82644,214,240,37,43,534
73,2013-04-22,31.553,19732,21082,25849,24499,91162,219,246,38,49,552
74,2013-04-23,31.6235,21121,22424,26879,25576,96000,226,258,42,49,575
75,2013-04-24,31.46,24997,24886,26974,27085,103942,227,266,41,51,585
76,2013-04-25,31.173,25737,24039,28635,30333,108744,223,274,43,50,590
77,2013-04-26,31.254,26107,24229,28456,30334,109126,223,278,42,50,593
78,2013-04-29,30.927,26279,24517,28559,30321,109676,227,281,43,50,601
79,2013-04-30,31.121,26113,25061,27608,28660,107442,222,288,44,50,604
80,2013-05-02,31.173,26159,25107,27608,28660,107534,223,289,44,50,606
81,2013-05-03,31.053,26265,25212,27608,28661,107746,226,295,44,50,615
82,2013-05-06,31.04,27190,26138,27608,28660,109596,226,294,44,50,614
83,2013-05-07,31.0565,27097,25254,27688,29531,109570,229,299,44,52,624
84,2013-05-08,31.118,26953,25109,28705,30549,111316,233,301,47,56,637
85,2013-05-10,31.36,27137,24789,28571,30919,111416,233,298,46,57,634
86,2013-05-13,31.3475,27324,24924,28523,30923,111694,240,300,48,57,645
87,2013-05-14,31.356,27253,24853,28523,30923,111552,240,303,48,57,648
88,2013-05-15,31.45,27259,25248,28489,30500,111496,251,300,47,56,654
89,2013-05-16,31.3615,28453,26084,27881,30250,112668,250,308,53,56,667
90,2013-05-17,31.421,28402,26739,28571,30234,113946,255,314,53,56,678
91,2013-05-20,31.252,29315,27146,29408,31577,117446,253,320,52,58,683
92,2013-05-21,31.238,32305,31270,31485,32520,127580,251,329,54,58,692
93,2013-05-22,31.425,34655,34632,32494,32517,134298,254,324,56,58,692
94,2013-05-23,31.407,34665,35200,33158,32623,135646,262,321,55,58,696
95,2013-05-24,31.32,35351,35590,32862,32623,136426,258,326,54,58,696
96,2013-05-27,31.362,35726,35939,32842,32629,137136,259,333,54,58,704
97,2013-05-28,31.515,35990,36060,32984,32914,137948,261,330,54,58,703
98,2013-05-29,31.5925,36568,36473,32973,33068,139082,270,335,54,60,719
99,2013-05-30,31.727,37816,35895,36339,38260,148310,274,339,55,63,731
100,2013-05-31,31.952,38203,35550,36541,39194,149488,280,343,55,66,744
101,2013-06-03,31.779,38239,34167,36109,40181,148696,301,357,57,71,786
102,2013-06-04,31.905,40102,37167,37031,39966,154266,294,362,59,71,786
103,2013-06-05,32.165,41765,38574,37056,40247,157642,310,369,57,74,810
104,2013-06-06,32.12,43080,42471,42413,43022,170986,317,391,64,78,850
105,2013-06-07,32.1675,47876,46655,42145,43366,180042,329,412,66,79,886
106,2013-06-10,32.307,47704,47178,41880,42406,179168,326,413,65,80,884
107,2013-06-11,32.394,48265,47602,42836,43499,182202,327,427,66,87,907
108,2013-06-13,31.948,46797,51282,52830,48345,199254,325,435,70,90,920
109,2013-06-14,31.729,45277,51100,52735,46912,196024,315,428,71,90,904
110,2013-06-17,31.7375,4521,2648,6190,8063,21422,41,66,29,29,165
111,2013-06-18,32.005,7603,5452,6795,8946,28796,70,100,35,26,231
112,2013-06-19,32.469,10331,7356,6946,9921,34554,94,129,36,29,288
113,2013-06-20,33.046,13387,10058,9978,13307,46730,151,166,42,42,401
114,2013-06-21,32.783,16737,11624,10085,15198,53644,181,183,44,47,455
115,2013-06-24,32.71,16310,11658,10551,15203,53722,187,190,47,48,472
116,2013-06-25,32.81,17206,11888,11139,16457,56690,205,206,46,57,514
117,2013-06-26,32.955,18584,12844,12520,18260,62208,223,213,50,59,545
118,2013-06-27,32.7995,19420,13625,13279,19074,65398,236,216,50,62,564
119,2013-06-28,32.803,35386,29607,29192,34971,129156,243,218,51,63,575
120,2013-07-01,32.972,35679,29896,29445,35228,130248,253,227,52,62,594
121,2013-07-02,33.1505,36167,30231,31098,37034,134530,263,230,53,65,611
122,2013-07-03,33.1295,37298,31312,31121,37107,136838,280,243,54,67,644
123,2013-07-04,33.192,37853,32154,31416,37115,138538,293,258,55,68,674
124,2013-07-05,33.3245,39351,33792,31569,37128,141840,297,266,56,69,688
125,2013-07-08,33.2235,40881,36285,33834,38430,149430,305,275,57,70,707
126,2013-07-09,32.9935,43355,38782,34053,38626,154816,304,284,55,72,715
127,2013-07-10,32.898,43730,38964,34135,38901,155730,305,293,56,74,728
128,2013-07-11,32.514,43414,39566,34575,38423,155978,298,305,58,76,737
129,2013-07-12,32.64,43666,40572,37219,40313,161770,293,308,64,80,745
130,2013-07-15,32.575,43841,41133,37567,40275,162816,287,318,69,78,752
131,2013-07-16,32.4,44134,41005,38030,41159,164328,283,326,70,77,756
132,2013-07-17,32.3395,45794,40999,38512,43307,168612,286,328,70,79,763
133,2013-07-18,32.49,46133,41675,38731,43189,169728,286,329,70,78,763
134,2013-07-19,32.3115,46558,42470,38959,43047,171034,288,332,70,77,767
135,2013-07-22,32.338,47533,43619,39179,43093,173424,293,344,71,77,785
136,2013-07-23,32.3045,48312,44701,39287,42898,175198,289,345,72,77,783
137,2013-07-24,32.4605,48922,44980,41831,45773,181506,301,349,77,78,805
138,2013-07-25,32.6185,49736,45371,42067,46432,183606,309,343,81,78,811
139,2013-07-26,32.7895,49791,45533,42096,46354,183774,316,341,80,77,814
140,2013-07-29,32.8295,54615,50648,42872,46839,194974,324,341,81,75,821
141,2013-07-30,32.9635,54796,50739,42784,46841,195160,335,344,82,75,836
142,2013-07-31,32.9795,55864,53422,47426,49868,206580,348,349,82,80,859
143,2013-08-01,33.074,55681,53348,48621,50954,208604,352,350,85,79,866
144,2013-08-02,32.8475,56947,54724,50603,52826,215100,347,360,88,81,876
145,2013-08-05,32.9055,57921,55894,51896,53923,219634,351,365,89,80,885
146,2013-08-06,32.963,59074,56705,52005,54374,222158,355,366,89,79,889
147,2013-08-07,32.9745,59392,57610,52069,53851,222922,352,371,89,79,891
148,2013-08-08,32.8375,59975,57734,51965,54206,223880,358,367,90,79,894
149,2013-08-09,32.8855,60563,59064,52154,53653,225434,363,369,89,80,901
150,2013-08-12,32.997,61075,59426,52509,54158,227168,368,370,90,80,908
151,2013-08-13,33.1,62485,60568,60171,62088,245312,371,381,93,83,928
152,2013-08-14,33.0825,63773,60052,60764,64485,249074,377,384,92,81,934
153,2013-08-15,32.88,65207,61784,61216,64639,252846,382,387,93,84,946
154,2013-08-16,32.901,69353,65377,61091,65067,260888,389,388,93,83,953
155,2013-08-19,32.98,70519,66139,61146,65526,263330,391,390,95,82,958
156,2013-08-20,32.956,71331,67874,61291,64748,265244,392,398,93,84,967
157,2013-08-21,33.123,67399,65403,61332,63328,257462,397,403,93,84,977
158,2013-08-22,33.057,68072,65942,62917,65047,261978,401,406,94,84,985
159,2013-08-23,33.015,68069,66657,63077,64489,262292,405,413,96,84,998
160,2013-08-26,33.0695,68808,68288,63860,64380,265336,409,419,97,86,1011
161,2013-08-27,33.1775,68864,68278,63713,64299,265154,415,422,100,88,1025
162,2013-08-28,33.21,69122,68368,64894,65648,268032,417,428,102,89,1036
163,2013-08-29,33.25,69178,68837,65307,65648,268970,418,429,102,89,1038
164,2013-08-30,33.3145,69718,68730,65110,66098,269656,417,424,105,85,1031
165,2013-09-02,33.345,70467,68508,64502,66461,269938,427,436,108,87,1058
166,2013-09-03,33.519,71007,69218,64808,66597,271630,435,445,109,87,1076
167,2013-09-04,33.3475,71722,70742,65956,66936,275356,433,455,109,90,1087
168,2013-09-05,33.424,71594,70249,68154,69499,279496,442,456,109,93,1100
169,2013-09-06,33.27,71941,70607,68500,69834,280882,436,461,110,95,1102
170,2013-09-09,33.168,72180,69681,69251,71750,282862,425,458,113,94,1090
171,2013-09-10,32.97,69662,67734,69402,71330,278128,430,453,110,95,1088
172,2013-09-11,32.754,66619,66205,69982,70396,273202,419,451,105,97,1072
173,2013-09-12,32.6345,62369,66128,71274,67515,267286,403,449,108,95,1055
174,2013-09-13,32.48,62213,66875,69905,65243,264236,412,461,105,94,1072
175,2013-09-16,32.2775,22738,20953,34298,36083,114072,88,103,45,34,270
176,2013-09-17,32.225,24662,23499,38600,39763,126524,118,155,55,39,367
177,2013-09-18,31.8215,25607,24172,38542,39977,128298,141,175,55,41,412
178,2013-09-19,31.6365,27834,26395,38783,40222,133234,165,210,60,49,484
179,2013-09-20,31.853,31082,27830,39209,42461,140582,175,232,63,58,528
180,2013-09-23,31.8035,31836,28190,39077,42723,141826,181,237,64,57,539
181,2013-09-24,31.885,32280,28534,39070,42816,142700,191,254,65,58,568
182,2013-09-25,32.101,33526,28309,38986,44203,145024,198,260,63,62,583
183,2013-09-26,32.325,34671,29433,39906,45144,149154,210,266,67,65,608
184,2013-09-27,32.355,35446,29195,39996,46247,150884,228,269,67,68,632
185,2013-09-30,32.41,36791,30110,40510,47191,154602,234,285,69,68,656
186,2013-10-01,32.227,37354,30156,40684,47882,156076,235,287,70,68,660
187,2013-10-02,32.234,37264,30277,40861,47848,156250,237,291,71,67,666
188,2013-10-03,32.1445,35758,30632,40876,46002,153268,235,303,74,65,677
189,2013-10-04,32.1815,36082,30699,40957,46340,154078,240,307,73,66,686
190,2013-10-07,32.265,36811,31036,44721,50496,163064,240,309,72,71,692
191,2013-10-08,32.405,36969,31155,45723,51537,165384,253,311,72,72,708
192,2013-10-09,32.325,38163,31832,45975,52306,168276,257,311,73,71,712
193,2013-10-10,32.1975,39853,33600,47181,53434,174068,269,316,72,72,729
194,2013-10-11,32.2855,40290,34014,47214,53490,175008,277,319,72,72,740
195,2013-10-14,32.28,40503,34211,47272,53564,175550,288,323,71,72,754
196,2013-10-15,32.29,32882,30477,47321,49726,160406,177,213,54,58,502
197,2013-10-16,32.113,34561,31848,47514,50227,164150,208,244,57,60,569
198,2013-10-17,31.884,34394,32187,48107,50314,165002,201,262,61,60,584
199,2013-10-18,31.931,35014,32633,48068,50449,166164,214,281,64,62,621
200,2013-10-21,31.9475,35332,33248,48197,50281,167058,212,285,63,62,622
201,2013-10-22,31.6875,36003,33918,48370,50455,168746,226,298,66,63,653
202,2013-10-23,31.77,36264,34242,48507,50529,169542,237,313,67,63,680
203,2013-10-24,31.7275,36913,34894,48547,50566,170920,242,318,64,61,685
204,2013-10-25,31.762,36076,34904,49265,50437,170682,241,324,68,62,695
205,2013-10-28,31.911,37307,36183,49337,50461,173288,236,334,66,63,699
206,2013-10-29,32.088,38078,36747,50678,52009,177512,243,350,65,62,720
207,2013-10-30,32.0185,38419,36873,50703,52249,178244,249,354,65,64,732
208,2013-10-31,32.096,38541,37313,51370,52598,179822,249,348,66,61,724
209,2013-11-01,32.42,39578,37688,54730,56620,188616,258,349,68,62,737
210,2013-11-05,32.553,40954,37859,54912,58007,191732,277,355,71,66,769
211,2013-11-06,32.384,41477,38002,55184,58659,193322,291,369,75,68,803
212,2013-11-07,32.429,42002,38399,55457,59060,194918,292,375,79,64,810
213,2013-11-08,32.6365,44703,40116,55442,60029,200290,305,372,81,64,822
214,2013-11-11,32.796,46424,40598,55414,61240,203676,329,386,81,63,859
215,2013-11-12,32.8905,49197,44212,60222,65207,218838,361,406,82,66,915
216,2013-11-13,32.736,49852,45339,61024,65537,221752,359,408,83,66,916
217,2013-11-14,32.66,50856,46945,62783,66694,227278,366,418,82,70,936
218,2013-11-15,32.589,44257,41530,63641,66368,215796,239,294,70,63,666
219,2013-11-18,32.575,45065,41815,65911,69161,221952,246,316,70,66,698
220,2013-11-19,32.746,47869,43453,67126,71542,229990,254,315,73,66,708
221,2013-11-20,32.9335,50167,44458,66789,72498,233912,261,319,72,67,719
222,2013-11-21,32.992,52672,46836,67036,72872,239416,286,336,73,69,764
223,2013-11-22,32.7555,61589,53253,67789,76125,258756,287,349,73,73,782
224,2013-11-25,32.934,71257,59296,67074,79035,276662,296,362,71,75,804
225,2013-11-26,32.9405,71211,59314,67124,79021,276670,299,366,71,75,811
226,2013-11-27,33.18,71528,60125,67426,78829,277908,308,369,73,73,823
227,2013-11-28,33.148,73108,61438,67461,79131,281138,341,384,72,74,871
228,2013-11-29,33.1555,73516,61819,67485,79182,282002,350,386,72,74,882
229,2013-12-02,33.2395,76210,62818,68097,81489,288614,361,401,72,75,909
230,2013-12-03,33.2685,76927,62747,68651,82831,291156,365,409,71,75,920
231,2013-12-04,33.1815,76720,63563,70256,83413,293952,369,413,73,76,931
232,2013-12-05,32.9855,77121,64040,70986,84067,296214,376,420,74,77,947
233,2013-12-06,32.7,79934,65512,71305,85727,302478,375,430,73,80,958
234,2013-12-09,32.7525,79013,65122,71461,85352,300948,370,435,74,79,958
235,2013-12-10,32.7005,82150,66159,71230,87221,306760,372,443,74,80,969
236,2013-12-11,32.778,82674,66974,73491,89191,312330,375,446,75,80,976
237,2013-12-12,32.7915,73817,63480,75786,86123,299206,377,447,78,77,979
238,2013-12-13,32.8505,72135,60121,74546,86560,293362,380,434,76,77,967
239,2013-12-16,32.9025,30103,27279,39424,42248,139054,105,108,25,25,263
240,2013-12-17,32.9695,31132,27957,40231,43406,142726,131,135,27,27,320
241,2013-12-18,32.814,31412,28173,40213,43452,143250,146,145,29,29,349
242,2013-12-19,32.99,32162,28540,40240,43862,144804,157,162,31,31,381
243,2013-12-20,32.98,32675,29271,40452,43856,146254,161,174,33,30,398
244,2013-12-23,32.661,33713,30332,40462,43843,148350,176,187,32,31,426
245,2013-12-24,32.64,35356,31984,40472,43844,151656,193,192,32,32,449
246,2013-12-25,32.6905,36050,33639,41427,43838,154954,205,196,34,32,467
247,2013-12-26,32.6665,36201,33810,41447,43838,155296,203,198,38,32,471
248,2013-12-27,32.5945,36609,33899,41935,44645,157088,199,208,38,37,482
249,2013-12-30,32.835,41173,35384,43275,49064,168896,207,219,39,39,504
250,2014-01-06,33.2125,37563,36474,44450,45539,164026,224,233,42,38,537
251,2014-01-08,33.1935,37928,36817,44450,45561,164756,228,243,42,39,552
252,2014-01-09,33.234,39029,37303,44449,46175,166956,233,256,42,40,571
253,2014-01-10,33.027,39098,37385,44744,46457,167684,244,261,41,41,587
254,2014-01-13,33.2825,38857,37229,44964,46592,167642,252,273,42,41,608
255,2014-01-14,33.302,39526,37715,44961,46772,168974,269,285,41,43,638
256,2014-01-15,33.4,35023,31422,43171,46772,156388,190,193,38,44,465
257,2014-01-16,33.4125,37158,34383,44014,46789,162344,213,235,45,45,538
258,2014-01-17,33.5905,38097,35103,44199,47193,164592,232,254,46,48,580
259,2014-01-20,33.768,40780,36604,43929,48105,169418,296,294,47,59,696
260,2014-01-21,33.935,48863,42060,44889,51692,187504,354,339,50,69,812
261,2014-01-22,33.9305,51525,44280,45973,53218,194996,390,360,56,71,877
262,2014-01-23,34.115,57272,48335,47209,56146,208962,427,406,61,72,966
263,2014-01-24,34.527,64522,55703,51851,60670,232746,514,440,77,76,1107
264,2014-01-27,34.69,71489,60134,54507,65862,251992,596,496,88,85,1265
265,2014-01-28,34.742,73045,63413,56849,66481,259788,612,521,93,88,1314
266,2014-01-29,35.1305,85924,69304,61293,77913,294434,717,556,88,97,1458
267,2014-01-30,34.905,92391,84784,79576,87183,343934,784,602,107,104,1597
268,2014-01-31,35.196,97758,86960,79322,90120,354160,840,619,108,106,1673
269,2014-02-03,35.44,99855,87892,76860,88823,353430,850,627,107,108,1692
270,2014-02-04,35.003,103130,87050,75108,91188,356476,884,641,113,118,1756
271,2014-02-05,34.898,102891,85435,71799,89255,349380,881,650,118,122,1771
272,2014-02-06,34.694,103992,83796,70440,90636,348864,899,654,124,124,1801
273,2014-02-07,34.7685,105710,81606,69682,93786,350784,888,660,130,122,1800
274,2014-02-10,34.76,106037,82668,70952,94321,353978,902,667,133,120,1822
275,2014-02-11,34.7525,106209,81924,70605,94890,353628,904,677,133,122,1836
276,2014-02-12,34.831,106331,81341,70572,95562,353806,907,678,134,123,1842
277,2014-02-13,35.1495,110230,87877,74177,96530,368814,933,686,132,123,1874
278,2014-02-14,35.08,112171,91459,78136,98848,380614,934,706,133,124,1897
279,2014-02-17,35.2195,82691,63165,68700,88226,302782,611,425,96,90,1222
280,2014-02-18,35.4115,86172,65938,69084,89318,310512,658,471,110,92,1331
281,2014-02-19,35.795,91933,69842,72341,94432,328548,730,518,122,97,1467
282,2014-02-20,35.775,99800,72142,71424,99082,342448,768,553,127,103,1551
283,2014-02-21,35.489,102136,73874,73182,101444,350636,794,575,128,115,1612
284,2014-02-24,35.483,104825,76744,75749,103830,361148,790,586,130,119,1625
285,2014-02-25,35.705,105446,77697,77973,105722,366838,800,595,127,117,1639
286,2014-02-26,36.0195,111068,76258,79206,114016,380548,869,621,127,118,1735
287,2014-02-27,36.036,115548,77415,79775,117908,390646,912,636,136,125,1809
288,2014-02-28,35.886,117981,79280,80142,118843,396246,946,674,140,132,1892
289,2014-03-03,36.51,114791,75662,79536,118665,388654,945,658,135,133,1871
290,2014-03-04,36.065,109969,79141,90513,121341,400964,945,684,141,136,1906
291,2014-03-05,36.0435,116410,80339,92199,128270,417218,944,681,146,132,1903
292,2014-03-06,36.1365,116817,81845,110344,145316,454322,945,685,142,136,1908
293,2014-03-07,36.4695,118655,81946,109830,146539,456970,979,685,141,138,1943
294,2014-03-11,36.5,123480,81247,110178,152411,467316,1005,690,143,140,1978
295,2014-03-12,36.5,126003,82393,109825,153435,471656,1020,688,145,142,1995
296,2014-03-13,36.6085,126275,82909,111826,155192,476202,1025,695,148,142,2010
297,2014-03-14,36.597,125461,83717,116336,158080,483594,1035,703,150,141,2029
298,2014-03-17,36.33,33966,29411,42044,46599,152020,253,184,45,61,543
299,2014-03-18,36.2205,45519,33233,44892,57178,180822,337,238,51,90,716
300,2014-03-19,36.136,46525,35283,45414,56656,183878,363,262,55,95,775
301,2014-03-20,36.38,47840,36727,45385,56498,186450,386,280,57,94,817
302,2014-03-21,36.2595,49445,37819,45225,56851,189340,392,295,56,95,838
303,2014-03-24,36.052,51146,37894,45221,58473,192734,400,301,55,94,850
304,2014-03-25,35.56,53473,38998,45344,59819,197634,423,320,55,100,898
305,2014-03-26,35.53,54857,40602,46134,60389,201982,435,333,61,105,934
306,2014-03-27,35.5905,56385,42118,46163,60430,205096,434,338,61,105,938
307,2014-03-28,35.78,57071,42850,47479,61700,209100,443,341,63,108,955
308,2014-03-31,35.12,60686,43673,45571,62584,212514,454,342,69,105,970
309,2014-04-01,35.0995,60482,45913,49706,64275,220376,456,365,73,113,1007
310,2014-04-02,35.418,61520,46682,52468,67306,227976,470,376,75,115,1036
311,2014-04-03,35.5,61434,47612,56088,69910,235044,470,387,80,119,1056
312,2014-04-04,35.3,61046,47548,58032,71530,238156,471,398,84,118,1071
313,2014-04-07,35.642,60566,47040,58582,72108,238296,481,395,83,116,1075
314,2014-04-08,35.6805,61393,48609,61787,74571,246360,484,400,84,117,1085
315,2014-04-09,35.642,61590,50056,62818,74352,248816,494,407,84,118,1103
316,2014-04-10,35.57,61692,50188,62871,74375,249126,502,409,85,116,1112
317,2014-04-11,35.645,61900,50391,63472,74981,250744,508,412,85,115,1120
318,2014-04-14,35.9845,62674,51078,65059,76655,255466,524,419,84,117,1144
319,2014-04-15,36.1925,49327,40736,61965,70556,222584,329,241,64,86,720
320,2014-04-16,35.9885,52577,43090,64225,73712,233604,374,280,69,91,814
321,2014-04-17,35.46,55712,45589,65572,75695,242568,385,305,69,98,857
322,2014-04-18,35.6105,56444,46323,65580,75701,244048,407,329,76,101,913
323,2014-04-21,35.7265,56784,46757,65780,75807,245128,419,342,78,101,940
324,2014-04-22,35.699,57441,49641,70255,78055,255392,436,348,77,103,964
325,2014-04-23,35.6755,57581,50590,71377,78368,257916,439,351,75,106,971
326,2014-04-24,35.772,58369,51211,72057,79215,260852,440,359,75,105,979
327,2014-04-25,36.0285,59214,51454,72175,79935,262778,449,368,74,107,998
328,2014-04-28,35.821,59960,53080,76164,83044,272248,451,376,72,108,1007
329,2014-04-29,35.602,59903,53224,78429,85108,276664,441,391,72,109,1013
330,2014-04-30,35.63,60576,53252,78408,85732,277968,446,397,70,110,1023
331,2014-05-02,35.8735,60680,53416,78834,86098,279028,456,405,78,110,1049
332,2014-05-05,35.7195,60922,53162,78813,86573,279470,460,409,77,116,1062
333,2014-05-06,35.41,61326,52318,79230,88238,281112,460,418,80,114,1072
334,2014-05-07,34.9295,61687,52834,79833,88686,283040,456,440,76,118,1090
335,2014-05-08,35.04,62570,52170,81481,91881,288102,469,459,82,118,1128
336,2014-05-12,35.0425,62835,52661,83054,93228,291778,472,464,86,120,1142
337,2014-05-13,34.8525,64859,52843,83395,95411,296508,471,469,88,123,1151
338,2014-05-14,34.72,65381,52313,81481,94549,293724,473,474,90,127,1164
339,2014-05-15,34.75,59730,45700,78532,92562,276524,375,324,72,103,874
340,2014-05-16,34.77,60285,46705,78865,92445,278300,381,339,74,105,899
341,2014-05-19,34.5655,59800,45480,80844,95164,281288,394,361,84,110,949
342,2014-05-20,34.5215,60823,46591,81038,95270,283722,400,377,86,110,973
343,2014-05-21,34.345,61843,47076,81657,96424,287000,402,384,88,111,985
344,2014-05-22,34.3195,64393,48154,76625,92864,282036,411,391,86,118,1006
345,2014-05-23,34.17,65137,48029,80070,97178,290414,422,398,88,120,1028
346,2014-05-26,34.2035,65785,48004,79932,97713,291434,428,400,86,123,1037
347,2014-05-27,34.406,65045,49194,82349,98200,294788,424,415,89,124,1052
348,2014-05-28,34.5615,65034,49240,82867,98661,295802,434,420,90,127,1071
349,2014-05-29,34.658,65391,48023,82093,99461,294968,444,415,92,127,1078
350,2014-05-30,34.8945,66998,47778,82879,102099,299754,456,415,93,127,1091
351,2014-06-02,34.93,68557,47992,81476,102041,300066,470,419,94,129,1112
352,2014-06-03,35.0695,68340,47911,82052,102481,300784,477,421,96,133,1127
353,2014-06-04,34.9995,71428,48618,81428,104238,305712,496,435,96,135,1162
354,2014-06-05,34.7415,71901,47923,80883,104861,305568,498,441,93,138,1170
355,2014-06-06,34.418,75783,47938,83765,111610,319096,482,444,94,141,1161
356,2014-06-09,34.34,76979,46887,86050,116142,326058,500,443,96,142,1181
357,2014-06-10,34.365,78203,46474,83266,114995,322938,513,438,96,142,1189
358,2014-06-11,34.379,79562,46591,82871,115842,324866,516,438,94,144,1192
359,2014-06-13,34.452,78154,46767,82240,113627,320788,522,450,94,143,1209
360,2014-06-16,34.6385,19433,7800,19388,31021,77642,140,104,32,42,318
361,2014-06-17,34.8265,23070,10792,19915,32193,85970,173,140,38,51,402
362,2014-06-18,34.42,25298,12924,21462,33836,93520,201,162,41,61,465
363,2014-06-19,34.396,27277,13685,22101,35693,98756,228,195,47,70,540
364,2014-06-20,34.479,28853,14728,21863,35988,101432,229,209,52,68,558
365,2014-06-23,34.127,29561,14755,21849,36655,102820,243,217,50,70,580
366,2014-06-24,33.8175,31089,15109,22835,38815,107848,269,251,61,77,658
367,2014-06-25,33.7455,31846,15309,24609,41146,112910,270,266,66,81,683
368,2014-06-26,33.72,32786,15853,26009,42942,117590,277,280,65,84,706
369,2014-06-27,33.738,32524,16366,28836,44994,122720,289,288,72,97,746
370,2014-06-30,33.9825,33791,18231,28969,44529,125520,294,302,72,99,767
371,2014-07-01,34.34,36101,18423,29038,46716,130278,315,294,75,102,786
372,2014-07-02,34.281,40029,19074,30840,51795,141738,323,300,75,107,805
373,2014-07-03,34.284,41934,19344,37537,60127,158942,336,299,83,106,824
374,2014-07-04,34.42,44022,20159,37778,61641,163600,341,309,86,106,842
375,2014-07-07,34.455,44451,20325,40570,64696,170042,342,301,86,107,836
376,2014-07-08,34.23,44481,20064,42111,66528,173184,357,299,86,107,849
377,2014-07-09,33.9125,45137,21251,43214,67100,176702,351,304,91,107,853
378,2014-07-10,33.95,45415,21763,43940,67592,178710,345,307,91,109,852
379,2014-07-11,34.2055,46178,21638,45290,69830,182936,358,313,90,113,874
380,2014-07-14,34.3275,46504,21828,45584,70260,184176,360,319,90,116,885
381,2014-07-15,34.3945,37897,13057,41574,66414,158942,211,150,61,83,505
382,2014-07-16,34.3875,38148,12979,42104,67273,160504,237,172,63,91,563
383,2014-07-17,35.182,45256,15616,49347,78987,189206,277,202,76,102,657
384,2014-07-18,35.1425,45110,16124,51983,80969,194186,303,217,82,112,714
385,2014-07-21,35.19,45879,16967,59142,88054,210042,327,227,84,114,752
386,2014-07-22,34.996,47774,17145,62762,93391,221072,334,232,89,116,771
387,2014-07-23,34.8995,47036,17777,65548,94807,225168,324,242,99,116,781
388,2014-07-24,35.0435,48812,18624,67125,97313,231874,349,252,100,120,821
389,2014-07-25,35.13,51904,19165,67457,100196,238722,366,257,98,126,847
390,2014-07-28,35.5425,32666,29656,89459,92469,244250,363,270,123,127,883
391,2014-07-29,35.8045,36086,31542,90134,94678,252440,395,289,124,135,943
392,2014-07-30,35.586,38906,33672,97259,102493,272330,422,295,123,139,979
393,2014-07-31,35.7485,40586,33536,98122,105172,277416,432,296,125,139,992
394,2014-08-01,35.7495,40856,34250,100217,106823,282146,438,305,132,142,1017
395,2014-08-04,35.783,42305,35493,105185,111997,294980,455,304,132,144,1035
396,2014-08-05,36.0785,46273,37844,106158,114587,304862,465,313,136,143,1057
397,2014-08-06,36.189,46231,39098,109356,116489,311174,485,330,138,139,1092
398,2014-08-07,36.27,49604,42636,119935,126903,339078,495,350,143,145,1133
399,2014-08-08,36.1205,51680,44278,122146,129548,347652,542,371,148,149,1210
400,2014-08-11,35.929,54789,45594,128952,138147,367482,540,378,152,147,1217
401,2014-08-12,36.18,55276,45708,134087,143655,378726,548,375,157,148,1228
402,2014-08-13,36.0005,61343,46732,134485,149096,391656,561,384,157,147,1249
403,2014-08-14,36.036,70529,47425,134848,157952,410754,570,391,155,151,1267
404,2014-08-15,36.131,44156,33570,131036,141622,350384,377,216,123,103,819
405,2014-08-18,36.0595,46808,35872,130947,141883,355510,399,243,126,106,874
406,2014-08-19,36.185,47546,35555,132337,144328,359766,410,254,128,107,899
407,2014-08-20,36.3005,50357,35290,134357,149424,369428,418,270,130,111,929
408,2014-08-21,36.024,53244,36270,134749,151723,375986,433,279,133,115,960
409,2014-08-22,36.11,53214,34698,136920,155436,380268,455,284,133,118,990
410,2014-08-25,36.095,54402,35232,137138,156308,383080,461,287,134,120,1002
411,2014-08-26,36.1005,56478,35827,138407,159058,389770,477,298,136,118,1029
412,2014-08-27,36.172,54888,37911,151194,168171,412164,475,305,139,125,1044
413,2014-08-28,36.75,59360,39236,150879,171003,420478,513,318,142,128,1101
414,2014-08-29,37.1235,60668,40292,151702,172078,424740,563,345,150,135,1193
415,2014-09-01,37.302,70796,44846,168805,194755,479202,654,355,159,151,1319
416,2014-09-02,37.4625,73269,47301,184430,210398,515398,688,371,166,162,1387
417,2014-09-03,36.863,72669,45773,191218,218114,527774,666,392,174,171,1403
418,2014-09-04,37.0075,73946,52749,212644,233841,573180,673,419,168,189,1449
419,2014-09-05,36.92,77415,59807,260300,277908,675430,682,432,178,195,1487
420,2014-09-08,37.0695,78293,56433,270643,292503,697872,708,427,182,194,1511
421,2014-09-09,37.1115,80411,58948,273208,294671,707238,713,433,182,194,1522
422,2014-09-10,37.29,82753,62447,278199,298505,721904,740,436,182,194,1552
423,2014-09-11,37.5095,96967,66642,299748,330073,793430,788,451,201,193,1633
424,2014-09-12,37.785,110523,72401,326691,364813,874428,876,460,214,198,1748
425,2014-09-15,38.385,35020,37979,109946,106987,289932,367,174,99,101,741
426,2014-09-16,38.33,51562,51638,152363,152287,407850,568,265,123,131,1087
427,2014-09-17,38.419,54924,54867,156956,157013,423760,596,297,128,131,1152
428,2014-09-18,38.478,59897,51719,160490,168668,440774,623,302,133,145,1203
429,2014-09-19,38.4215,58635,53016,164891,170510,447052,637,316,138,144,1235
430,2014-09-22,38.6995,62719,53906,169906,178719,465250,678,322,143,142,1285
431,2014-09-23,38.616,68420,55999,173647,186068,484134,707,342,151,139,1339
432,2014-09-24,38.15,66412,55025,177143,188530,487110,697,353,162,140,1352
433,2014-09-25,38.4915,69585,58368,177342,188559,493854,738,365,166,145,1414
434,2014-09-26,39.1765,82645,64910,185619,203354,536528,813,380,169,154,1516
435,2014-09-29,39.4395,96436,68404,187948,215980,568768,894,421,187,168,1670
436,2014-09-30,39.5925,109552,74365,194144,229331,607392,942,443,189,183,1757
437,2014-10-01,39.7,112282,75652,195153,231783,614870,1010,454,190,191,1845
438,2014-10-02,39.561,115928,80113,199617,235432,631090,1035,473,189,195,1892
439,2014-10-03,39.957,121003,83167,200830,238666,643666,1090,476,196,199,1961
440,2014-10-06,39.73,125029,82166,204657,247520,659372,1167,492,201,205,2065
441,2014-10-07,39.904,129751,80007,209372,259116,678246,1202,492,205,211,2110
442,2014-10-08,40.0,129832,82854,217441,264419,694546,1228,503,210,218,2159
443,2014-10-09,40.1475,131424,82617,217120,265927,697088,1233,506,212,229,2180
444,2014-10-10,40.325,136779,84042,216467,269204,706492,1309,537,213,235,2294
445,2014-10-13,40.4925,141918,86733,217615,272800,719066,1371,556,207,253,2387
446,2014-10-14,40.92,160971,111171,211559,261359,745060,1464,618,220,264,2566
447,2014-10-15,40.4505,74206,67756,98686,105136,345784,709,333,142,140,1324
448,2014-10-16,40.869,80518,85362,125013,120169,411062,836,381,153,158,1528
449,2014-10-17,40.7525,86210,85895,132204,132519,436828,884,407,171,177,1639
450,2014-10-20,41.0375,89354,89841,133670,133183,446048,925,431,176,189,1721
451,2014-10-21,40.964,93598,94239,141270,140629,469736,964,452,178,193,1787
452,2014-10-22,41.4195,96358,94247,146001,148112,484718,1004,451,188,199,1842
453,2014-10-23,41.715,104090,100176,149374,153288,506928,1095,487,194,224,2000
454,2014-10-24,41.906,112542,111615,239932,240859,704948,1233,540,214,244,2231
455,2014-10-27,42.28,126160,117712,293151,301599,838622,1327,598,250,268,2443
456,2014-10-28,42.468,139968,120599,308428,327797,896792,1434,653,270,283,2640
457,2014-10-29,43.2,154916,131140,337440,361216,984712,1603,740,280,305,2928
458,2014-10-30,41.6445,165736,134263,345425,376898,1022322,1664,870,306,341,3181
459,2014-10-31,43.034,169478,135403,349977,384052,1038910,1729,881,306,349,3265
460,2014-11-03,43.608,173145,137747,352395,387793,1051080,1808,901,309,365,3383
461,2014-11-05,44.95,182735,140185,358427,400977,1082324,1980,954,352,414,3700
462,2014-11-06,46.8675,204076,144040,411609,471645,1231370,2258,1038,401,459,4156
463,2014-11-07,46.65,207668,156089,425239,476818,1265814,2436,1160,473,490,4559
464,2014-11-10,45.8525,208038,158253,603158,652943,1622392,2417,1224,502,529,4672
465,2014-11-11,46.3515,212655,160243,611479,663891,1648268,2507,1260,511,545,4823
466,2014-11-12,45.9615,218819,163718,622675,677776,1682988,2542,1294,528,552,4916
467,2014-11-13,46.82,227764,167597,628093,688260,1711714,2606,1314,540,562,5022
468,2014-11-14,47.1735,230458,170385,631329,691402,1723574,2746,1348,538,574,5206
469,2014-11-17,47.1045,179848,123688,572188,628348,1504072,1938,634,363,337,3272
470,2014-11-18,46.9025,190464,127465,570271,633270,1521470,2035,746,374,351,3506
471,2014-11-19,46.861,190132,129658,577767,638241,1535798,2089,811,381,372,3653
472,2014-11-20,46.152,191048,134896,588201,644353,1558498,2121,872,387,381,3761
473,2014-11-21,45.714,192280,139290,1144301,1197291,2673162,2131,929,402,377,3839
474,2014-11-24,44.997,191587,139740,1146786,1198633,2676746,2116,960,414,399,3889
475,2014-11-25,46.263,198426,140401,947406,1005431,2291664,2151,984,424,395,3954
476,2014-11-26,47.388,196813,141532,948953,1004234,2291532,2246,1010,428,404,4088
477,2014-11-27,48.655,202055,144335,999104,1056824,2402318,2305,1050,434,422,4211
478,2014-11-28,50.4085,204733,147520,1003101,1060314,2415668,2396,1134,465,457,4452
479,2014-12-01,51.22,207786,144392,1002384,1065778,2420340,2619,1200,478,515,4812
480,2014-12-02,53.85,216468,145910,1001942,1072500,2436820,2805,1226,502,533,5066
481,2014-12-03,53.1905,221491,151878,1005986,1075599,2454954,2946,1337,541,559,5383
482,2014-12-04,54.29,224200,153716,1010903,1081387,2470206,2989,1391,554,584,5518
483,2014-12-05,52.51,223784,155897,1012690,1080577,2472948,2981,1472,625,597,5675
484,2014-12-08,53.745,221846,156399,1015679,1081126,2475050,2994,1487,639,596,5716
485,2014-12-09,54.049,227193,160261,1015338,1082270,2485062,3032,1521,636,607,5796
486,2014-12-10,54.85,229508,164042,1016811,1082277,2492638,3092,1588,648,613,5941
487,2014-12-11,56.44,236039,169303,1017261,1083997,2506600,3160,1640,670,619,6089
488,2014-12-12,58.18,249608,176374,1021988,1095222,2543192,3341,1776,685,642,6444
489,2014-12-15,64.4455,9074,18094,92432,83412,203012,458,327,80,165,1030
490,2014-12-16,67.5,10932,23107,96855,84680,215574,651,440,110,202,1403
491,2014-12-17,60.2205,11608,16826,91798,86580,206812,724,479,135,224,1562
492,2014-12-18,61.5,12709,17558,82079,77230,189576,803,537,155,231,1726
493,2014-12-19,58.55,13373,18333,82330,77370,191406,849,582,164,230,1825
494,2014-12-22,55.8,13516,19037,82289,76768,191610,885,658,190,246,1979
495,2014-12-23,54.5035,13535,19301,82697,76931,192464,896,679,192,250,2017
496,2014-12-24,53.44,15661,15605,79600,79656,190522,917,693,209,265,2084
497,2014-12-25,52.5515,16609,15746,79211,80074,191640,935,732,220,277,2164
498,2014-12-26,54.004,17645,11387,74858,81116,185006,962,717,220,302,2201
499,2014-12-29,58.322,19777,12241,74644,82180,188842,997,737,225,313,2272
500,2014-12-29,58.322,19777,12241,74644,82180,188842,997,737,225,313,2272
501,2014-12-30,56.0,21132,12208,74767,83691,191798,1023,756,230,330,2339
502,2015-01-05,60.85,21813,12163,74592,84242,192810,1066,778,231,343,2418
503,2015-01-06,63.24,23380,12844,74852,85388,196464,1162,800,247,355,2564
504,2015-01-08,60.301,24297,13691,75284,85890,199162,1190,817,255,355,2617
505,2015-01-09,61.55,25297,13708,74996,86585,200586,1238,824,253,356,2671
506,2015-01-12,63.17,26602,14386,74705,86921,202614,1295,822,249,373,2739
507,2015-01-13,65.25,29841,15003,75849,90687,211380,1408,871,287,423,2989
508,2015-01-14,64.773,30857,16784,79296,93369,220306,1452,903,295,434,3084
509,2015-01-15,65.29,14422,8039,76169,82552,181182,572,347,183,233,1335
510,2015-01-16,65.1985,16218,11719,81412,85911,195260,671,451,210,273,1605
511,2015-01-19,65.02,16846,12224,83131,87753,199954,726,487,225,291,1729
512,2015-01-20,65.2,17939,13093,83569,88415,203016,758,513,224,303,1798
513,2015-01-21,65.35,19607,20883,97515,96239,234244,788,542,230,314,1874
514,2015-01-22,64.12,20267,21762,104442,102947,249418,811,556,236,324,1927
515,2015-01-23,64.2395,21510,21975,106398,105933,255816,841,575,248,342,2006
516,2015-01-26,68.799,22798,22566,106359,106591,258314,880,605,258,361,2104
517,2015-01-27,66.82,25959,23192,106984,109751,265886,968,654,270,390,2282
518,2015-01-28,68.0345,27710,23371,108080,112419,271580,1026,673,287,404,2390
519,2015-01-29,68.73,29683,24154,107680,113209,274726,1110,707,290,423,2530
520,2015-01-30,68.9105,31896,25792,109902,116006,283596,1213,759,306,438,2716
521,2015-02-02,68.42,36436,30566,119662,125532,312196,1272,811,335,474,2892
522,2015-02-03,65.168,39901,37952,129518,131467,338838,1261,866,350,478,2955
523,2015-02-04,67.993,41362,40759,131501,132104,345726,1308,899,358,482,3047
524,2015-02-05,66.6,43906,41794,133448,135560,354708,1316,928,366,485,3095
525,2015-02-06,66.985,45669,42723,136048,138994,363434,1354,942,368,494,3158
526,2015-02-09,65.86,45157,43754,138401,139804,367116,1348,966,375,496,3185
527,2015-02-10,65.455,46865,45644,143678,144899,381086,1374,979,382,502,3237
528,2015-02-11,65.25,47966,45747,146239,148458,388410,1403,997,391,513,3304
529,2015-02-12,65.27,50608,46703,147484,151389,396184,1414,991,403,511,3319
530,2015-02-13,63.5,50442,47899,147749,150292,396382,1390,1004,411,512,3317
531,2015-02-16,63.184,30982,15685,102064,117361,266092,889,504,279,331,2003
532,2015-02-17,62.505,33263,21050,109661,121874,285848,957,573,291,353,2174
533,2015-02-18,61.582,34999,21882,110581,123698,291160,1003,602,304,358,2267
534,2015-02-19,61.9,35358,23492,114533,126399,299782,1021,634,319,360,2334
535,2015-02-20,62.05,36243,24850,115520,126913,303526,1049,655,322,368,2394
536,2015-02-24,62.853,36334,26573,122276,132037,317220,1070,688,336,374,2468
537,2015-02-25,61.389,39715,29580,138158,148293,355746,1092,729,355,394,2570
538,2015-02-26,61.15,40896,33985,144659,151570,371110,1104,772,366,401,2643
539,2015-02-27,61.6,42208,35623,144974,151559,374364,1126,784,368,404,2682
540,2015-03-02,62.65,43808,38854,151148,156102,389912,1161,799,368,414,2742
541,2015-03-03,61.887,43824,42404,159399,160819,406446,1158,815,368,426,2767
542,2015-03-04,61.945,47263,40243,148768,155788,392062,1171,818,378,420,2787
543,2015-03-05,60.821,49686,41347,156781,165120,412934,1177,820,376,432,2805
544,2015-03-06,60.445,50528,39664,159538,170402,420132,1201,842,383,432,2858
545,2015-03-10,62.53,52109,39938,160663,172834,425544,1240,858,395,452,2945
546,2015-03-11,61.617,54877,41781,161030,174126,431814,1262,875,402,453,2992
547,2015-03-12,61.19,57620,48341,163002,172281,441244,1252,899,411,458,3020
548,2015-03-13,62.249,55902,43361,162608,175149,437020,1275,905,419,469,3068
549,2015-03-16,62.192,10708,10848,40160,40020,101736,219,168,78,92,557
550,2015-03-17,61.45,11765,13291,42069,40543,107668,290,248,89,115,742
551,2015-03-18,59.335,15169,14734,45080,45515,120498,346,301,97,129,873
552,2015-03-19,59.994,19645,15880,49796,53561,138882,422,343,131,153,1049
553,2015-03-20,59.255,20541,15640,54533,59434,150148,458,354,149,160,1121
554,2015-03-23,58.741,23230,15028,56106,64308,158672,511,364,169,174,1218
555,2015-03-24,57.69,26649,17985,68848,77512,190994,546,435,199,192,1372
556,2015-03-25,57.45,34996,18099,64707,81604,199406,605,476,216,205,1502
557,2015-03-26,57.291,37364,18645,63138,81857,201004,627,509,218,223,1577
558,2015-03-27,57.9,39083,20759,63135,81459,204436,654,527,217,231,1629
559,2015-03-30,57.61,40314,21373,63303,82244,207234,663,543,225,238,1669
560,2015-03-31,58.205,41093,22207,63870,82756,209926,678,556,225,235,1694
561,2015-04-01,57.61,41742,23238,71726,90230,226936,703,571,230,241,1745
562,2015-04-02,56.65,43301,23661,74459,94099,235520,713,605,245,254,1817
563,2015-04-03,56.606,45763,26594,81312,100481,254150,739,611,254,270,1874
564,2015-04-06,55.488,48357,27731,91168,111794,279050,750,643,281,272,1946
565,2015-04-07,55.026,56915,28460,82529,110984,278888,791,677,291,282,2041
566,2015-04-08,53.637,65085,28543,93876,130418,317922,848,713,317,302,2180
567,2015-04-09,51.862,66015,29109,98598,135504,329226,903,762,351,337,2353
568,2015-04-10,53.6,71548,32049,101062,140561,345220,1006,822,386,376,2590
569,2015-04-13,52.03,77393,33006,111870,156257,378526,1075,879,387,394,2735
570,2015-04-14,50.897,78497,33316,114089,159270,385172,1081,910,394,394,2779
571,2015-04-15,49.7,28560,15177,47635,61018,152390,602,411,223,245,1481
572,2015-04-16,49.8,32325,17540,51347,66132,167344,715,509,260,284,1768
573,2015-04-17,51.895,34480,19986,57981,72475,184922,806,549,270,310,1935
574,2015-04-20,53.335,39150,23110,63401,79441,205102,864,623,287,345,2119
575,2015-04-21,53.8,42314,28635,70793,84472,226214,934,705,300,372,2311
576,2015-04-22,52.18,45713,33720,81447,93440,254320,981,731,316,382,2410
577,2015-04-23,50.78,49732,39748,89161,99145,277786,1000,777,311,395,2483
578,2015-04-24,50.9,50823,41328,90055,99550,281756,1004,803,314,392,2513
579,2015-04-27,51.978,52400,42329,90983,101054,286766,1041,834,317,402,2594
580,2015-04-28,51.546,54345,43180,90831,101996,290352,1062,846,321,406,2635
581,2015-04-29,51.055,58036,43488,92236,106784,300544,1092,858,330,405,2685
582,2015-04-30,51.69,56311,44127,97615,109799,307852,1116,869,339,416,2740
583,2015-05-05,50.496,57777,44913,100026,112890,315606,1106,882,339,424,2751
584,2015-05-06,50.998,58675,50816,122602,130461,362554,1105,910,347,432,2794
585,2015-05-07,50.29,64366,55610,136168,144924,401068,1133,933,355,436,2857
586,2015-05-08,51.04,66754,59378,146219,153595,425946,1155,949,358,438,2900
587,2015-05-12,49.958,71201,56863,142010,156348,426422,1168,954,360,439,2921
588,2015-05-13,49.27,74650,59968,141376,156058,432052,1185,983,376,438,2982
589,2015-05-14,50.134,77766,63539,216930,231157,589392,1211,992,383,455,3041
590,2015-05-15,49.57,46920,35386,169466,181000,432772,761,544,272,320,1897
591,2015-05-18,49.147,50516,33956,175229,191789,451490,857,625,284,338,2104
592,2015-05-19,49.57,50597,38421,178017,190193,457228,892,677,294,340,2203
593,2015-05-20,49.701,52467,39807,180083,192743,465100,951,708,302,352,2313
594,2015-05-21,49.99,55890,41813,224099,238176,559978,995,725,314,361,2395
595,2015-05-22,50.028,55785,43829,225576,237532,562722,991,743,320,365,2419
596,2015-05-25,49.965,55610,46179,226329,235760,563878,992,757,326,364,2439
597,2015-05-26,50.96,57827,46206,226301,237922,568256,1017,759,327,356,2459
598,2015-05-27,51.99,64320,46893,234928,252355,598496,1072,781,331,377,2561
599,2015-05-28,52.6,83242,56173,236744,263813,639972,1175,822,346,387,2730
600,2015-05-29,52.31,79500,57093,242579,264986,644158,1223,831,352,398,2804
601,2015-06-01,53.625,83198,56881,242114,268431,650624,1291,854,354,415,2914
602,2015-06-02,52.78,80759,59749,252052,273062,665622,1319,868,363,422,2972
603,2015-06-03,54.3,84465,69418,266044,281091,701018,1404,892,364,429,3089
604,2015-06-04,56.46,98249,76539,270148,291858,736794,1575,961,382,461,3379
605,2015-06-05,56.245,115743,82794,279395,312344,790276,1769,1028,401,478,3676
606,2015-06-08,55.995,129498,92613,289280,326165,837556,1858,1057,417,491,3823
607,2015-06-09,55.545,132871,102702,307662,337831,881066,1905,1076,424,506,3911
608,2015-06-10,54.331,133556,105306,316138,344388,899388,1827,1157,431,514,3929
609,2015-06-11,54.798,137550,109171,323592,351971,922284,1832,1171,434,528,3965
610,2015-06-15,54.5,31693,25710,182936,188919,429258,513,336,144,196,1189
611,2015-06-16,53.78,36286,28593,190254,197947,453080,602,422,165,219,1408
612,2015-06-17,53.6,41242,31290,241746,251698,565976,682,461,174,227,1544
613,2015-06-18,53.47,53187,32690,250087,270584,606548,741,515,200,252,1708
614,2015-06-19,54.0,56613,36105,255482,275990,624190,791,541,198,265,1795
615,2015-06-22,53.95,57256,38127,304057,323186,722626,846,554,208,278,1886
616,2015-06-23,53.855,57558,40052,308382,325888,731880,863,575,213,282,1933
617,2015-06-24,54.446,60728,41732,311778,330774,745012,889,582,216,284,1971
618,2015-06-25,54.72,59761,45656,344594,358699,808710,902,609,210,296,2017
619,2015-06-26,54.78,63296,51219,345512,357589,817616,951,647,222,295,2115
620,2015-06-29,55.715,70547,53065,346409,363891,833912,984,681,230,306,2201
621,2015-06-30,55.3,77117,55349,346776,368544,847786,1034,707,235,317,2293
622,2015-07-01,55.843,81546,60245,355759,377060,874610,1076,748,240,323,2387
623,2015-07-02,55.53,83704,66240,363165,380629,893738,1093,762,239,327,2421
624,2015-07-03,56.0,85811,68051,365751,383511,903124,1138,796,247,339,2520
625,2015-07-06,56.889,88220,68500,371086,390806,918612,1201,805,243,348,2597
626,2015-07-07,56.739,94643,70387,366511,390767,922308,1301,823,249,349,2722
627,2015-07-08,57.513,98516,71603,366145,393058,929322,1378,900,244,368,2890
628,2015-07-09,57.17,101504,73300,365562,393766,934132,1380,943,244,373,2940
629,2015-07-10,56.429,102176,75894,367839,394121,940030,1394,942,252,372,2960
630,2015-07-13,56.52,102684,76711,369654,395627,944676,1407,953,254,381,2995
631,2015-07-14,56.414,107811,76912,370304,401203,956230,1430,955,266,387,3038
632,2015-07-15,56.938,64528,27970,292724,329282,714504,598,412,167,204,1381
633,2015-07-16,56.95,70143,31571,320954,359526,782194,704,504,188,215,1611
634,2015-07-17,56.987,78411,32519,329923,375815,816668,762,531,192,223,1708
635,2015-07-20,57.0,85694,34698,330577,381573,832542,827,545,206,231,1809
636,2015-07-21,56.938,91716,36982,362604,417338,908640,890,571,229,243,1933
637,2015-07-22,57.445,94693,39781,367841,422753,925068,923,595,228,254,2000
638,2015-07-23,57.851,97174,43918,371164,424420,936676,978,614,229,258,2079
639,2015-07-24,58.425,103606,47339,384001,440268,975214,1091,662,243,271,2267
640,2015-07-27,59.645,110909,49709,391342,452542,1004502,1198,705,263,284,2450
641,2015-07-28,60.02,132240,61282,419526,490484,1103532,1336,766,283,322,2707
642,2015-07-29,58.67,136718,62793,423949,497874,1121334,1364,805,287,339,2795
643,2015-07-30,59.748,141746,66284,424714,500176,1132920,1395,818,295,337,2845
644,2015-07-31,61.72,150373,71404,432146,511115,1165038,1519,860,305,350,3034
645,2015-08-03,63.515,159749,82754,449623,526618,1218744,1826,967,342,394,3529
646,2015-08-04,63.07,166765,88531,474635,552869,1282800,1972,1061,361,408,3802
647,2015-08-05,63.461,172765,91355,477535,558945,1300600,2048,1081,370,428,3927
648,2015-08-06,64.02,199102,94930,501534,605706,1401272,2233,1115,387,462,4197
649,2015-08-07,64.045,212751,97985,518011,632777,1461524,2337,1148,399,475,4359
650,2015-08-10,62.81,223759,102827,536665,657597,1520848,2393,1199,418,482,4492
651,2015-08-11,64.28,238304,104831,552521,685994,1581650,2484,1203,428,476,4591
652,2015-08-12,64.21,249129,110585,556699,695243,1611656,2563,1233,433,496,4725
653,2015-08-13,64.705,256761,115374,560262,701649,1634046,2634,1259,441,504,4838
654,2015-08-14,64.997,272873,122577,561534,711830,1668814,2646,1283,450,505,4884
655,2015-08-17,65.51,191685,68304,491694,615075,1366758,1451,714,275,337,2777
656,2015-08-18,65.881,215469,81945,494784,628308,1420506,1625,792,294,364,3075
657,2015-08-19,66.605,240194,89932,514477,664739,1509342,1834,802,321,367,3324
658,2015-08-20,67.959,264414,103424,522725,683715,1574278,2054,873,332,404,3663
659,2015-08-21,69.108,291782,116199,528861,704444,1641286,2283,929,349,435,3996
660,2015-08-24,70.9,326955,138971,539326,727310,1732562,2766,1078,399,496,4739
661,2015-08-25,68.85,358055,154712,555394,758737,1826898,2817,1128,420,514,4879
662,2015-08-26,68.901,363654,165971,564131,761814,1855570,2931,1149,430,521,5031
663,2015-08-27,66.009,356318,163736,574220,766802,1861076,2823,1181,458,529,4991
664,2015-08-28,65.402,345708,165673,583383,763418,1858182,2773,1210,474,530,4987
665,2015-08-31,64.249,356567,168307,587033,775293,1887200,2827,1240,482,544,5093
666,2015-09-01,66.85,362812,169314,586029,779527,1897682,2753,1292,495,557,5097
667,2015-09-02,67.079,391023,178119,593166,806070,1968378,2854,1310,493,568,5225
668,2015-09-03,67.2,404957,180571,590977,815363,1991868,2907,1343,499,574,5323
669,2015-09-04,68.42,403177,182350,590018,810845,1986390,2941,1367,505,574,5387
670,2015-09-07,69.114,419687,184635,586343,821395,2012060,3027,1387,522,592,5528
671,2015-09-08,67.99,430059,192548,593866,831377,2047850,3081,1423,531,609,5644
672,2015-09-09,68.485,439527,194123,596791,842195,2072636,3125,1451,538,618,5732
673,2015-09-10,67.668,447843,196991,604779,855631,2105244,3139,1475,540,637,5791
674,2015-09-11,67.924,461772,209842,625788,877718,2175120,3188,1469,558,636,5851
675,2015-09-14,67.49,473800,208179,633202,898823,2214004,3223,1428,562,647,5860
676,2015-09-15,66.7,162828,51795,129266,240299,584188,891,371,164,234,1660
677,2015-09-16,65.33,184192,51327,140822,273687,650028,1104,477,187,259,2027
678,2015-09-17,65.437,192392,59532,150219,283079,685222,1240,507,194,276,2217
679,2015-09-18,66.502,194073,74047,160097,280123,708340,1314,552,212,288,2366
680,2015-09-21,65.988,195216,75119,164845,284942,720122,1365,580,219,294,2458
681,2015-09-22,66.022,200376,75732,166274,290918,733300,1410,603,225,304,2542
682,2015-09-23,66.42,208160,77462,181646,312344,779612,1454,626,231,313,2624
683,2015-09-24,66.099,219208,104268,220097,335037,878610,1495,666,233,321,2715
684,2015-09-25,65.53,224367,104177,220304,340494,889342,1499,685,236,328,2748
685,2015-09-28,66.085,232085,104999,219808,346894,903786,1544,698,232,330,2804
686,2015-09-29,65.73,229701,103902,227750,353549,914902,1587,723,236,328,2874
687,2015-09-30,65.39,235545,103007,230647,363185,932384,1640,739,245,332,2956
688,2015-10-01,65.65,236054,103922,252343,384475,976794,1696,753,255,350,3054
689,2015-10-02,66.012,239913,114074,287902,413741,1055630,1704,774,260,353,3091
690,2015-10-05,64.749,231588,124460,307970,415098,1079116,1656,826,264,372,3118
691,2015-10-06,63.33,239472,130544,322183,431111,1123310,1605,860,283,380,3128
692,2015-10-07,62.664,243262,124266,324083,443079,1134690,1592,874,311,386,3163
693,2015-10-08,61.37,251980,128551,334162,457591,1172284,1632,885,324,385,3226
694,2015-10-09,61.876,255963,128989,339199,466173,1190324,1646,924,333,410,3313
695,2015-10-12,62.275,273314,126779,340895,487430,1228418,1710,945,344,409,3408
696,2015-10-13,63.039,290649,135912,344569,499306,1270436,1823,965,355,412,3555
697,2015-10-14,62.709,298002,139421,345259,503840,1286522,1894,983,360,423,3660
698,2015-10-15,61.403,134484,38074,175134,271544,619236,984,506,196,252,1938
699,2015-10-16,61.285,149521,41111,180127,288537,659296,1170,594,219,256,2239
700,2015-10-19,62.262,159934,42460,181055,298529,681978,1252,642,225,261,2380
701,2015-10-20,62.115,168179,54365,185150,298964,706658,1309,681,230,269,2489
702,2015-10-21,63.005,175604,58070,187847,305381,726902,1402,714,239,275,2630
703,2015-10-22,62.591,181630,59827,188625,310428,740510,1452,738,243,273,2706
704,2015-10-23,62.38,185156,61195,190209,314170,750730,1474,758,245,278,2755
705,2015-10-26,63.02,198133,63611,190032,324554,776330,1546,765,251,279,2841
706,2015-10-27,64.9,218893,68014,206641,357520,851068,1685,823,273,289,3070
707,2015-10-28,63.95,228352,84635,215543,359260,887790,1730,893,283,307,3213
708,2015-10-29,64.4,236804,88340,214364,362828,902336,1758,929,286,315,3288
709,2015-10-30,63.958,246861,89639,215549,372771,924820,1793,946,284,314,3337
710,2015-11-02,63.665,259092,91155,219383,387320,956950,1838,952,297,322,3409
711,2015-11-03,62.628,264752,112878,244775,396649,1019054,1805,969,294,330,3398
712,2015-11-05,63.45,266585,114188,244590,396987,1022350,1805,981,294,330,3410
713,2015-11-06,64.598,276982,118017,244065,403030,1042094,1867,1009,298,328,3502
714,2015-11-09,64.59,300950,120494,240712,421168,1083324,1938,1014,304,336,3592
715,2015-11-10,64.56,308812,123064,241047,426795,1099718,1954,1037,310,342,3643
716,2015-11-11,65.415,316129,126194,242176,432111,1116610,1987,1052,316,353,3708
717,2015-11-12,66.635,330931,137392,245651,439190,1153164,2158,1117,327,360,3962
718,2015-11-13,66.777,349980,154402,252453,448031,1204866,2246,1133,347,365,4091
719,2015-11-16,65.27,384362,157966,261506,487902,1291736,2305,1165,349,386,4205
720,2015-11-17,65.148,388688,159801,268252,497139,1313880,2308,1235,356,385,4284
721,2015-11-18,64.753,394428,161986,269628,502070,1328112,2278,1255,368,390,4291
722,2015-11-19,64.618,241752,57410,182970,367312,849444,1222,635,227,251,2335
723,2015-11-20,64.75,245498,58911,186429,373016,863854,1297,685,243,260,2485
724,2015-11-23,65.836,257367,61253,190865,386979,896464,1389,717,250,271,2627
725,2015-11-24,65.452,266490,64603,192295,394182,917570,1450,748,265,291,2754
726,2015-11-25,65.525,270771,63272,196935,404434,935412,1484,765,270,297,2816
727,2015-11-26,65.837,276928,66555,203132,413505,960120,1503,791,274,300,2868
728,2015-11-27,66.48,278825,67645,204238,415418,966126,1543,785,278,303,2909
729,2015-11-30,66.49,282634,71875,208501,419260,982270,1568,828,282,310,2988
730,2015-12-01,66.61,286228,74023,214403,426608,1001262,1574,863,286,314,3037
731,2015-12-02,67.5,291536,103805,374423,562154,1331918,1600,879,295,341,3115
732,2015-12-03,67.508,293260,107479,373725,559506,1333970,1697,937,303,362,3299
733,2015-12-04,68.135,314898,106729,366948,575117,1363692,1771,950,302,382,3405
734,2015-12-07,69.499,333398,114375,376312,595335,1419420,1875,997,317,404,3593
735,2015-12-08,69.4,335941,118144,382371,600168,1436624,2015,1045,339,424,3823
736,2015-12-09,69.368,344408,124471,394938,614875,1478692,2092,1066,345,425,3928
737,2015-12-10,69.15,357114,129442,404640,632312,1523508,2174,1070,360,439,4043
738,2015-12-11,70.362,369256,138447,410620,641429,1559752,2272,1117,372,446,4207
739,2015-12-14,70.555,395070,155954,418257,657373,1626654,2492,1192,405,458,4547
740,2015-12-15,69.941,147927,59448,180796,269275,657446,759,345,147,206,1457
741,2015-12-16,70.396,155199,62018,186740,279921,683878,938,417,164,226,1745
742,2015-12-17,71.183,168891,65817,191655,294729,721092,1110,479,167,243,1999
743,2015-12-18,70.948,173883,68795,192872,297960,733510,1221,530,181,253,2185
744,2015-12-21,71.233,176174,70158,194203,300219,740754,1303,553,187,263,2306
745,2015-12-22,71.233,177836,68863,198742,307715,753156,1362,561,192,270,2385
746,2015-12-23,69.8,185882,70622,212837,328097,797438,1394,590,197,272,2453
747,2015-12-24,70.24,195913,70394,296288,421807,984402,1467,618,213,276,2574
748,2015-12-25,70.689,196362,70898,297734,423198,988192,1492,623,222,276,2613
749,2015-12-28,72.225,204052,73008,304367,435411,1016838,1624,626,230,287,2767
750,2015-12-29,72.205,212374,75972,307076,443478,1038900,1667,662,237,287,2853
751,2015-12-30,73.59,219039,81644,321868,459263,1081814,1726,686,249,293,2954
752,2016-01-04,73.16,235923,86476,327124,476571,1126094,1849,729,258,304,3140
753,2016-01-05,73.316,236580,85962,329460,480078,1132080,1881,723,265,309,3178
754,2016-01-06,74.76,240926,87212,329956,483670,1141764,1988,731,271,325,3315
755,2016-01-11,76.211,251487,94379,336190,493298,1175354,2179,805,285,359,3628
756,2016-01-12,77.065,264583,102310,355774,518047,1240714,2378,900,313,375,3966
757,2016-01-13,76.677,270517,106329,368025,532213,1277084,2520,982,329,396,4227
758,2016-01-14,76.051,274876,106850,372502,540528,1294756,2623,1001,333,409,4366
759,2016-01-15,77.603,286732,114283,394189,566638,1361842,2776,1041,350,419,4586
760,2016-01-18,79.29,315555,121840,415754,609469,1462618,3128,1115,371,442,5056
761,2016-01-19,78.561,338763,133642,433353,638474,1544232,3328,1163,390,463,5344
762,2016-01-20,81.4,348066,152378,504162,699850,1704456,3658,1268,419,511,5856
763,2016-01-21,82.63,213983,94760,368541,487764,1165048,2221,779,259,366,3625
764,2016-01-22,78.024,224325,98144,397876,524057,1244402,2374,1019,320,391,4104
765,2016-01-25,80.04,239221,100562,436593,575252,1351628,2544,1077,351,415,4387
766,2016-01-26,78.3,248182,107037,467712,608857,1431788,2751,1172,351,445,4719
767,2016-01-27,77.667,257056,107798,468193,617451,1450498,2858,1214,346,463,4881
768,2016-01-28,76.397,259192,110609,468334,616917,1455052,2828,1257,347,465,4897
769,2016-01-29,75.43,262379,114526,473115,620968,1470988,2760,1314,365,463,4902
770,2016-02-01,77.31,264264,116205,480096,628155,1488720,2833,1348,378,471,5030
771,2016-02-02,79.755,277415,122300,480463,635578,1515756,3008,1408,389,478,5283
772,2016-02-03,76.904,276025,134917,520305,661413,1592660,3060,1460,393,490,5403
773,2016-02-04,76.969,280985,137428,545349,688906,1652668,2924,1534,399,516,5373
774,2016-02-05,77.47,283964,140825,547675,690814,1663278,2984,1549,403,517,5453
775,2016-02-08,78.544,291666,141624,544563,694605,1672458,3069,1581,406,513,5569
776,2016-02-09,79.701,295163,143885,543496,694774,1677318,3162,1581,408,536,5687
777,2016-02-10,78.606,298068,145160,545397,698305,1686930,3235,1566,411,553,5765
778,2016-02-11,79.592,298871,148687,547657,697841,1693056,3294,1579,425,556,5854
779,2016-02-12,78.34,298453,150263,549704,697894,1696314,3347,1665,429,563,6004
780,2016-02-15,76.95,304053,156564,557515,705004,1723136,3319,1703,436,571,6029
781,2016-02-16,77.899,316349,160455,560809,716703,1754316,3350,1755,444,576,6125
782,2016-02-17,75.032,326108,169831,566426,722703,1785068,3324,1774,445,590,6133
783,2016-02-18,76.5,276359,127060,531148,680447,1615014,2209,987,302,407,3905
784,2016-02-19,76.986,294670,158110,556522,693082,1702384,2400,1131,320,425,4276
785,2016-02-20,77.05,295790,158524,556118,693384,1703816,2460,1160,314,428,4362
786,2016-02-22,75.3,295563,163122,563234,695675,1717594,2508,1218,332,431,4489
787,2016-02-24,75.711,309019,174425,575592,710186,1769222,2603,1257,339,445,4644
788,2016-02-25,75.385,320530,173318,571674,718886,1784408,2661,1287,348,459,4755
789,2016-02-26,76.2,330845,181532,572085,721398,1805860,2703,1334,353,464,4854
790,2016-02-29,75.2,339624,185128,578255,732751,1835758,2793,1361,350,471,4975
791,2016-03-01,73.392,360797,193898,582053,748952,1885700,2782,1464,364,479,5089
792,2016-03-02,73.07,360948,201845,587991,747094,1897878,2791,1554,364,501,5210
793,2016-03-03,73.171,363668,204159,590606,750115,1908548,2831,1586,376,506,5299
794,2016-03-04,71.97,362255,204722,594306,751839,1913122,2769,1603,388,509,5269
795,2016-03-07,71.471,350672,211047,607123,746748,1915590,2708,1671,405,521,5305
796,2016-03-09,71.141,353257,216600,611750,748407,1930014,2643,1727,411,526,5307
797,2016-03-10,71.455,357763,231208,625962,752517,1967450,2572,1814,415,556,5357
798,2016-03-11,69.883,360843,223872,624964,761935,1971614,2584,1885,414,585,5468
799,2016-03-14,69.96,377285,213731,621185,784739,1996940,2676,1892,433,621,5622
800,2016-03-15,71.04,71934,33734,59395,97595,262658,842,561,148,236,1787
801,2016-03-16,69.123,79755,61561,95321,113515,350152,1018,680,175,273,2146
802,2016-03-17,68.1,90913,57803,89032,122142,359890,1201,830,216,294,2541
803,2016-03-18,68.389,96945,60230,85944,122659,365778,1308,903,247,311,2769
804,2016-03-21,67.822,98684,60987,90924,128621,379216,1400,978,250,332,2960
805,2016-03-22,67.5,102294,62241,89664,129717,383916,1481,1013,267,346,3107
806,2016-03-23,68.737,110195,83856,127767,154106,475924,1615,1152,273,421,3461
807,2016-03-24,68.527,112443,86798,132485,158130,489856,1719,1198,276,433,3626
808,2016-03-25,68.454,114725,89111,132695,158309,494840,1745,1240,280,442,3707
809,2016-03-28,68.47,120391,96544,138806,162653,518394,1827,1290,273,452,3842
810,2016-03-29,68.05,120734,96857,141295,165172,524058,1881,1293,286,454,3914
811,2016-03-30,68.24,126415,99811,148565,175169,549960,1878,1318,295,462,3953
812,2016-03-31,67.025,131455,96499,151816,186772,566542,1874,1354,297,469,3994
813,2016-04-01,67.595,137801,99639,150888,189050,577378,1933,1377,304,479,4093
814,2016-04-04,68.7,143881,103660,153159,193380,594080,2008,1380,306,478,4172
815,2016-04-05,68.562,147169,106189,153751,194731,601840,2080,1420,315,488,4303
816,2016-04-06,67.59,151493,110587,154115,195021,611216,2084,1439,320,493,4336
817,2016-04-07,68.028,156138,115963,161198,201373,634672,2088,1459,330,504,4381
818,2016-04-08,67.15,169099,117826,167037,218310,672272,2111,1474,338,503,4426
819,2016-04-11,66.773,174558,112966,168591,230183,686298,2172,1485,357,508,4522
820,2016-04-12,65.715,181171,106675,168564,243060,699470,2153,1519,360,514,4546
821,2016-04-13,66.31,187291,107616,173360,253035,721302,2195,1521,370,530,4616
822,2016-04-14,66.11,197668,110368,171919,259219,739174,2233,1534,371,541,4679
823,2016-04-15,66.447,201130,111561,334545,424114,1071350,2279,1559,375,557,4770
824,2016-04-18,66.118,205063,113512,339410,430961,1088946,2313,1553,372,572,4810
825,2016-04-19,65.853,194451,115336,353764,432879,1096430,2315,1595,383,565,4858
826,2016-04-20,65.157,199826,116690,357201,440337,1114054,2364,1621,402,592,4979
827,2016-04-21,66.84,290068,57896,411312,643484,1402760,1216,851,248,412,2727
828,2016-04-22,66.455,299878,62578,416810,654110,1433376,1362,989,265,430,3046
829,2016-04-25,66.567,305441,67099,419840,658182,1450562,1479,1043,274,443,3239
830,2016-04-26,65.2,309351,70433,424767,663685,1468236,1527,1053,287,434,3301
831,2016-04-27,65.12,315203,70350,427254,672107,1484914,1601,1104,301,434,3440
832,2016-04-28,64.719,322754,70473,430438,682719,1506384,1644,1142,307,444,3537
833,2016-04-29,64.63,327615,74645,435135,688105,1525500,1684,1160,311,448,3603
834,2016-05-04,66.529,333234,77560,436039,691713,1538546,1774,1175,313,456,3718
835,2016-05-05,65.89,335793,78526,440537,697804,1552660,1786,1195,319,466,3766
836,2016-05-06,65.945,343211,79421,441405,705195,1569232,1862,1200,330,455,3847
837,2016-05-10,66.31,351226,79529,441552,713249,1585556,1896,1218,327,461,3902
838,2016-05-11,64.978,357584,84949,444711,717346,1604590,1914,1262,334,469,3979
839,2016-05-12,64.895,361935,87810,446897,721022,1617664,1944,1292,339,470,4045
840,2016-05-13,65.48,368788,88227,457671,738232,1652918,1970,1319,340,475,4104
841,2016-05-16,64.9,378026,87928,462515,752613,1681082,2057,1312,345,476,4190
842,2016-05-17,64.72,381933,91671,470054,760316,1703974,2107,1331,348,486,4272
843,2016-05-18,65.999,386681,91761,469351,764271,1712064,2189,1336,350,492,4367
844,2016-05-19,66.78,321233,63021,441324,699536,1525114,1430,855,280,403,2968
845,2016-05-20,66.798,329404,66448,447491,710447,1553790,1544,944,285,415,3188
846,2016-05-23,66.808,335638,69373,445293,711558,1561862,1620,1009,296,416,3341
847,2016-05-24,66.184,341295,70632,447030,717693,1576650,1647,1052,300,421,3420
848,2016-05-25,65.508,346302,72713,449316,722905,1591236,1680,1110,321,420,3531
849,2016-05-26,65.801,349529,76344,451918,725103,1602894,1710,1122,322,425,3579
850,2016-05-27,66.144,355404,79990,454457,729871,1619722,1765,1128,321,437,3651
851,2016-05-30,65.75,366158,83367,455000,737791,1642316,1801,1151,321,442,3715
852,2016-05-31,66.7,371261,84566,454444,741139,1651410,1840,1178,328,444,3790
853,2016-06-01,67.14,380028,89192,455304,746140,1670664,1928,1170,333,447,3878
854,2016-06-02,66.96,383382,91808,458408,749982,1683580,2008,1198,332,454,3992
855,2016-06-03,65.62,384791,95947,461883,750727,1693348,1976,1250,347,460,4033
856,2016-06-06,65.245,404170,96168,477655,785657,1763650,2033,1282,361,474,4150
857,2016-06-07,64.6225,414931,95576,476689,796044,1783240,2092,1278,364,476,4210
858,2016-06-08,63.61,426667,103042,465221,788846,1783776,2133,1323,376,489,4321
859,2016-06-09,64.3275,431074,104616,467036,793494,1796220,2222,1340,376,488,4426
860,2016-06-10,65.28,435356,104142,463202,794416,1797116,2274,1348,372,491,4485
861,2016-06-14,66.14,451188,116866,466012,800334,1834400,2427,1354,379,488,4648
862,2016-06-15,65.5125,60976,30367,43028,73637,208008,748,559,134,214,1655
863,2016-06-16,65.78,63648,36802,51293,78139,229882,896,680,154,219,1949
864,2016-06-17,64.85,78829,43552,66242,101519,290142,968,795,158,241,2162
865,2016-06-20,64.2975,80470,45854,81702,116318,324344,1032,857,162,252,2303
866,2016-06-21,63.755,85846,46938,81310,120218,334312,1144,885,162,260,2451
867,2016-06-22,64.89,98368,51273,80685,127780,358106,1209,922,166,268,2565
868,2016-06-23,63.85,107914,54759,107384,160539,430596,1323,960,191,272,2746
869,2016-06-24,65.2625,111947,59467,108791,161271,441476,1378,1041,190,292,2901
870,2016-06-27,65.4875,110031,66034,117912,161909,455886,1425,1069,200,288,2982
871,2016-06-28,64.1,120327,64864,123887,179350,488428,1455,1094,195,292,3036
872,2016-06-29,63.85,126614,63703,129383,192294,511994,1507,1142,204,305,3158
873,2016-06-30,63.99,131395,65001,131299,197693,525388,1541,1143,208,312,3204
874,2016-07-01,63.8,140828,65058,133318,209088,548292,1576,1141,215,316,3248
875,2016-07-04,63.935,143358,67287,139490,215561,565696,1615,1161,218,321,3315
876,2016-07-05,64.3175,151518,70228,142162,223452,587360,1667,1169,227,330,3393
877,2016-07-06,64.2075,160164,70730,146474,235908,613276,1713,1174,227,336,3450
878,2016-07-07,64.565,166654,76741,156605,246518,646518,1705,1203,248,352,3508
879,2016-07-08,63.98,178796,77501,163045,264340,683682,1728,1199,248,358,3533
880,2016-07-11,64.2,181060,77656,163246,266650,688612,1778,1215,250,364,3607
881,2016-07-12,63.89,186611,80264,165446,271793,704114,1804,1232,248,366,3650
882,2016-07-13,63.85,197880,85599,178365,290646,752490,1857,1236,253,373,3719
883,2016-07-14,62.85,196312,82814,183893,297391,760410,1909,1259,267,383,3818
884,2016-07-15,63.51,202325,84571,187276,305030,779202,1969,1274,272,383,3898
885,2016-07-18,62.8425,218906,83449,188968,324425,815748,2010,1301,277,389,3977
886,2016-07-19,63.5475,216982,84227,189991,322746,813946,2022,1300,284,393,3999
887,2016-07-20,63.74,213364,98430,196913,311847,820554,2021,1365,274,424,4084
888,2016-07-21,64.37,76570,45837,120155,150888,393450,911,722,154,246,2033
889,2016-07-22,64.88,82265,52943,127176,156498,418882,1068,864,167,264,2363
890,2016-07-25,65.415,115505,74607,145751,186649,522512,1205,939,178,267,2589
891,2016-07-26,65.9475,126382,77908,145203,193677,543170,1384,1024,189,269,2866
892,2016-07-27,65.9275,134646,80035,146710,201321,562712,1422,1041,188,276,2927
893,2016-07-28,66.615,146149,81964,141718,205903,575734,1566,1076,203,279,3124
894,2016-07-29,66.035,160979,86124,150686,225541,623330,1627,1153,212,294,3286
895,2016-08-01,66.895,166803,89856,150686,227633,634978,1681,1183,217,301,3382
896,2016-08-02,66.6475,172552,98988,155685,229249,656474,1722,1229,218,315,3484
897,2016-08-03,66.27,175749,101497,157036,231288,665570,1817,1303,222,330,3672
898,2016-08-04,65.7875,179995,102926,157905,234974,675800,1830,1320,225,341,3716
899,2016-08-05,65.5475,180443,104013,160933,237363,682752,1806,1357,236,345,3744
900,2016-08-08,64.615,180719,111609,178493,247603,718424,1835,1407,264,347,3853
901,2016-08-09,64.765,189627,113009,183257,259875,745768,1889,1404,262,344,3899
902,2016-08-10,64.87,196675,114405,186223,268493,765796,1871,1446,269,350,3936
903,2016-08-11,64.325,208350,122915,188654,274089,794008,1889,1480,268,352,3989
904,2016-08-12,64.75,221975,133671,192599,280903,829148,1898,1502,268,359,4027
905,2016-08-15,64.03,227947,135325,198033,290655,851960,1929,1514,278,361,4082
906,2016-08-16,63.775,235097,136512,214491,313076,899176,1919,1530,283,363,4095
907,2016-08-17,63.825,244590,141804,220398,323184,929976,1960,1517,280,361,4118
908,2016-08-18,63.65,122377,77089,187913,233201,620580,1224,967,171,249,2611
909,2016-08-19,63.9,141153,76919,178770,243004,639846,1369,1027,185,271,2852
910,2016-08-22,64.8125,146779,83462,181530,244847,656618,1456,1062,189,276,2983
911,2016-08-23,64.6,167326,86180,207344,288490,749340,1522,1094,194,285,3095
912,2016-08-24,65.17,169998,86928,207973,291043,755942,1570,1105,203,271,3149
913,2016-08-25,64.6625,176070,89495,211531,298106,775202,1604,1163,211,275,3253
914,2016-08-26,64.86,180684,90147,213239,303776,787846,1626,1166,222,288,3302
915,2016-08-29,64.75,185407,90225,210260,305442,791334,1668,1148,224,298,3338
916,2016-08-30,65.25,190359,92243,213628,311744,807974,1709,1167,224,311,3411
917,2016-08-31,65.315,201670,99515,228655,330810,860650,1774,1170,233,312,3489
918,2016-09-01,65.92,207762,98027,228448,338183,872420,1848,1172,237,321,3578
919,2016-09-02,65.095,216105,104485,236859,348479,905928,1831,1205,244,332,3612
920,2016-09-05,65.08,223415,104539,234060,352936,914950,1873,1218,244,337,3672
921,2016-09-06,64.5625,232247,109223,244835,367859,954164,1886,1249,249,335,3719
922,2016-09-07,64.135,236569,108436,248096,376229,969330,1902,1263,252,332,3749
923,2016-09-08,63.9975,233518,106298,253698,380918,974432,1876,1300,259,329,3764
924,2016-09-09,64.82,236085,111017,259627,384695,991424,1943,1316,264,331,3854
925,2016-09-12,64.5875,233301,112635,260643,381309,987888,1953,1323,263,338,3877
926,2016-09-13,65.2975,242354,114294,261057,389117,1006822,1982,1329,263,337,3911
927,2016-09-14,65.16,249800,114353,264565,400012,1028730,2005,1323,266,344,3938
928,2016-09-15,64.775,53268,24103,35794,64959,178124,651,524,100,151,1426
929,2016-09-16,65.12,69465,28099,41670,83036,222270,820,613,135,177,1745
930,2016-09-19,64.65,77360,32584,43579,88355,241878,893,677,143,186,1899
931,2016-09-20,64.7775,81796,35448,45964,92312,255520,977,726,151,196,2050
932,2016-09-21,63.81,86802,41756,50501,95547,274606,1039,781,165,208,2193
933,2016-09-22,63.7025,92725,49181,58695,102239,302840,1092,859,172,224,2347
934,2016-09-23,64.06,95263,50687,58069,102645,306664,1085,891,173,224,2373
935,2016-09-26,63.95,102132,53125,57953,106960,320170,1126,930,178,223,2457
936,2016-09-27,63.86,109965,60554,64998,114409,349926,1190,975,183,236,2584
937,2016-09-28,63.04,126386,60874,73931,139443,400634,1263,984,192,237,2676
938,2016-09-29,63.08,158227,71402,77062,163887,470578,1335,1034,194,256,2819
939,2016-09-30,62.805,158866,78215,83030,163681,483792,1349,1095,207,252,2903
940,2016-10-03,62.29,197031,80683,91271,207619,576604,1416,1162,218,263,3059
941,2016-10-04,62.665,205214,89746,95629,211097,601686,1490,1203,225,303,3221
942,2016-10-05,62.4375,207612,92984,102620,217248,620464,1525,1235,226,313,3299
943,2016-10-06,62.13,209676,96531,104900,218045,629152,1564,1264,230,316,3374
944,2016-10-07,62.2125,211331,100327,112138,223142,646938,1620,1297,235,319,3471
945,2016-10-10,62.005,211257,100530,116914,227641,656342,1656,1319,245,322,3542
946,2016-10-11,62.6625,223631,104310,119826,239147,686914,1713,1323,251,321,3608
947,2016-10-12,63.02,225813,106950,117011,235874,685648,1736,1340,240,304,3620
948,2016-10-13,63.03,235146,112283,123473,246336,717238,1827,1374,247,289,3737
949,2016-10-14,62.96,239054,107590,128197,259661,734502,1858,1385,255,300,3798
950,2016-10-17,63.11,241343,109697,131061,262707,744808,1901,1404,256,303,3864
951,2016-10-18,62.81,242212,115034,133327,260505,751078,1901,1423,266,308,3898
952,2016-10-19,62.285,233340,122376,145381,256345,757442,1860,1455,274,318,3907
953,2016-10-20,62.4875,74398,61468,65214,78144,279224,910,800,155,210,2075
954,2016-10-21,62.37,84542,64455,67375,87462,303834,1043,920,165,216,2344
955,2016-10-24,62.1825,94459,68840,91710,117329,372338,1128,996,181,221,2526
956,2016-10-25,62.24,102963,71650,117816,149129,441558,1194,1026,194,230,2644
957,2016-10-26,62.91,109999,77494,123436,155941,466870,1274,1068,185,242,2769
958,2016-10-27,62.7025,127032,85572,121720,163180,497504,1338,1124,190,246,2898
959,2016-10-28,63.02,127686,86942,124146,164890,503664,1367,1137,192,244,2940
960,2016-10-31,63.375,135350,91768,128605,172187,527910,1438,1152,200,250,3040
961,2016-11-01,63.32,144420,96044,133862,182238,556564,1484,1191,206,258,3139
962,2016-11-02,63.515,158817,110843,153613,201587,624860,1546,1217,203,267,3233
963,2016-11-03,63.58,174712,113367,155502,216847,660428,1610,1241,214,266,3331
964,2016-11-07,63.6325,187144,117262,167290,237172,708868,1666,1245,225,278,3414
965,2016-11-08,63.7625,200937,124094,185374,262217,772622,1748,1243,234,283,3508
966,2016-11-09,63.89,210843,123574,186756,274025,795198,1836,1288,244,296,3664
967,2016-11-10,65.4725,217835,127510,185114,275439,805898,1880,1278,244,291,3693
968,2016-11-11,65.72,237521,143385,203336,297472,881714,2162,1333,274,300,4069
969,2016-11-14,66.0325,250865,152441,206310,304734,914350,2294,1456,288,310,4348
970,2016-11-15,64.195,258734,156657,220424,322501,958316,2233,1556,294,314,4397
971,2016-11-16,64.7175,283367,171373,222355,334349,1011444,2226,1614,296,316,4452
972,2016-11-17,64.8,115908,87139,136716,165485,505248,1249,992,186,210,2637
973,2016-11-18,64.7025,127571,95996,143836,175411,542814,1350,1074,191,219,2834
974,2016-11-21,63.91,134421,100800,147589,181210,564020,1440,1135,193,228,2996
975,2016-11-22,63.7825,137723,112226,187061,212558,649568,1465,1200,199,235,3099
976,2016-11-23,64.4625,136967,112485,186566,211048,647066,1569,1253,205,237,3264
977,2016-11-24,64.485,141843,113279,187416,215980,658518,1606,1277,208,246,3337
978,2016-11-25,64.95,146110,114098,186217,218229,664654,1620,1283,217,257,3377
979,2016-11-28,64.84,153414,125910,193334,220838,693496,1689,1318,232,264,3503
980,2016-11-29,65.1125,176340,133723,198981,241598,750642,1786,1355,241,274,3656
981,2016-11-30,64.14,184921,137416,212171,259676,794184,1802,1376,259,293,3730
982,2016-12-01,63.98,195240,152378,240235,283097,870950,1807,1456,276,293,3832
983,2016-12-02,63.88,202602,152915,234982,284669,875168,1812,1465,281,294,3852
984,2016-12-05,63.82,215935,153699,255702,317938,943274,1849,1479,290,298,3916
985,2016-12-06,63.8725,214269,153112,260013,321170,948564,1846,1472,293,298,3909
986,2016-12-07,63.2275,213437,149356,256521,320602,939916,1858,1483,293,308,3942
987,2016-12-08,63.28,213037,152410,261829,322456,949732,1893,1496,295,313,3997
988,2016-12-09,62.495,207079,151870,263979,319188,942116,1855,1514,313,321,4003
989,2016-12-12,61.05,208914,147763,296773,357924,1011374,1870,1507,348,340,4065
990,2016-12-13,60.605,219262,149816,316368,385814,1071260,1915,1544,366,339,4164
991,2016-12-14,62.1,234922,147013,316914,404823,1103672,2003,1550,380,346,4279
992,2016-12-15,61.7475,70023,20611,102203,151615,344452,679,436,161,140,1416
993,2016-12-16,62.0825,91426,23624,106746,174548,396344,828,552,178,149,1707
994,2016-12-19,61.9475,110540,30816,108515,188239,438110,931,629,194,164,1918
995,2016-12-20,61.46,152751,43843,130454,239362,566410,984,712,213,170,2079
996,2016-12-21,61.1675,168845,50626,144121,262340,625932,1060,739,222,179,2200
997,2016-12-22,60.965,179293,48980,147633,277946,653852,1086,752,210,184,2232
998,2016-12-23,61.04,194398,51929,150539,293008,689874,1143,785,215,191,2334
999,2016-12-26,60.99,208986,64818,155832,300000,729636,1170,824,218,195,2407
1000,2016-12-26,60.99,208986,64818,155832,300000,729636,1170,824,218,195,2407
1001,2016-12-27,60.67,231829,66295,156549,322083,776756,1222,858,226,201,2507
1002,2016-12-28,60.335,239089,68984,160891,330996,799960,1281,867,232,204,2584
1003,2016-12-29,60.4,248417,75270,173044,346191,842922,1303,916,242,211,2672
1004,2016-12-30,61.2725,258740,76796,179208,361152,875896,1350,935,240,213,2738
1005,2017-01-03,60.9025,263238,77910,185643,370971,897762,1396,943,249,214,2802
1006,2017-01-04,60.46,270203,80916,188818,378105,918042,1424,935,252,220,2831
1007,2017-01-05,59.45,271763,78770,196261,389254,936048,1445,954,259,235,2893
1008,2017-01-06,59.62,276763,81661,194902,390004,943330,1507,981,263,236,2987
1009,2017-01-09,60.09,282660,83025,192918,392553,951156,1565,1022,264,242,3093
1010,2017-01-10,60.1675,285907,85896,194769,394780,961352,1624,1045,261,246,3176
1011,2017-01-11,59.7475,290669,83712,191632,398589,964602,1689,1058,267,241,3255
1012,2017-01-12,59.3325,291208,86187,203412,408433,989240,1663,1115,274,242,3294
1013,2017-01-13,59.66,296772,89392,203772,411152,1001088,1696,1144,282,244,3366
1014,2017-01-16,59.87,300556,90683,201562,411435,1004236,1729,1164,284,255,3432
1015,2017-01-17,59.41,284968,92931,198278,390315,966492,1687,1205,285,250,3427
1016,2017-01-18,59.56,287921,100119,205105,392907,986052,1679,1220,289,261,3449
1017,2017-01-19,59.72,41755,23402,64300,82653,212110,840,616,140,142,1738
1018,2017-01-20,59.755,84759,39542,79444,124661,328406,1005,731,141,159,2036
1019,2017-01-23,59.5175,114185,47190,96846,163841,422062,1137,806,165,177,2285
1020,2017-01-24,59.24,137655,51746,112538,198447,500386,1207,854,175,192,2428
1021,2017-01-25,59.5175,161571,60681,131239,232129,585620,1272,905,185,205,2567
1022,2017-01-26,60.4375,177268,70285,136862,243845,628260,1425,951,191,213,2780
1023,2017-01-27,59.83,183942,73312,142396,253026,652676,1412,988,196,235,2831
1024,2017-01-30,59.93,190508,79146,152103,263465,685222,1450,1001,205,241,2897
1025,2017-01-31,60.16,204562,84856,152534,272240,714192,1516,1017,203,244,2980
1026,2017-02-01,60.1325,218134,87893,151294,281535,738856,1578,1033,213,253,3077
1027,2017-02-02,59.425,233987,89901,172002,316088,811978,1577,1079,239,248,3143
1028,2017-02-03,58.9625,251653,96386,180400,335667,864106,1610,1102,251,254,3217
1029,2017-02-06,58.9025,275151,99702,184286,359735,918874,1689,1128,248,267,3332
1030,2017-02-07,59.32,297125,107838,180967,370254,956184,1778,1146,242,269,3435
1031,2017-02-08,59.23,302914,109554,186575,379935,978978,1797,1154,247,274,3472
1032,2017-02-09,58.95,305609,112903,189080,381786,989378,1836,1185,249,278,3548
1033,2017-02-10,58.24,314310,115511,186664,385463,1001948,1879,1220,252,284,3635
1034,2017-02-13,57.98,325227,121010,212607,416824,1075668,1968,1279,263,281,3791
1035,2017-02-14,57.1075,327486,126608,221899,422777,1098770,1968,1315,283,293,3859
1036,2017-02-15,57.265,354743,136113,227847,446477,1165180,2097,1367,296,300,4060
1037,2017-02-16,57.6,238979,93540,152937,298376,783832,1404,804,194,182,2584
1038,2017-02-17,58.4175,256779,104095,151919,304603,817396,1579,906,214,207,2906
1039,2017-02-20,57.95,269396,105780,153483,317099,845758,1705,952,253,217,3127
1040,2017-02-21,57.4025,295366,117708,152496,330154,895724,1716,1022,257,222,3217
1041,2017-02-22,58.0725,323390,124148,155683,354925,958146,1790,1044,271,233,3338
1042,2017-02-24,58.445,330716,124250,154900,361366,971232,1855,1056,274,240,3425
1043,2017-02-27,58.0525,331573,123769,159265,367069,981676,1845,1078,282,243,3448
1044,2017-02-28,58.2875,342173,122145,157398,377426,999142,1890,1077,276,254,3497
1045,2017-03-01,58.3075,362556,130214,159048,391390,1043208,1979,1096,283,259,3617
1046,2017-03-02,58.805,348272,120709,167954,395517,1032452,2045,1137,283,274,3739
1047,2017-03-03,58.23,357220,120856,179605,415969,1073650,2091,1174,296,272,3833
1048,2017-03-06,58.19,378137,125449,179221,431909,1114716,2090,1183,302,279,3854
1049,2017-03-07,58.18,395491,126808,188603,457286,1168188,2111,1200,272,283,3866
1050,2017-03-09,59.3175,417623,137647,185096,465072,1205438,2253,1157,270,290,3970
1051,2017-03-10,58.9975,415080,146161,192761,461680,1215682,2248,1214,272,285,4019
1052,2017-03-13,58.7725,420897,148070,190479,463306,1222752,2280,1200,273,289,4042
1053,2017-03-14,59.16,428291,148504,195261,475048,1247104,2352,1209,284,293,4138
1054,2017-03-15,58.39,451886,148319,194097,497664,1291966,2473,1219,285,293,4270
1055,2017-03-16,57.79,116066,34499,63828,145395,359788,747,459,112,112,1430
1056,2017-03-17,57.22,132832,38348,86426,180910,438516,916,566,140,137,1759
1057,2017-03-20,57.3025,160670,47624,93778,206824,508896,1100,655,156,154,2065
1058,2017-03-21,57.7,184012,45900,100836,238948,569696,1171,678,158,166,2173
1059,2017-03-22,57.7875,210368,58814,100768,252322,622272,1306,729,164,187,2386
1060,2017-03-23,57.465,216422,60595,98106,253933,629056,1322,766,166,184,2438
1061,2017-03-24,56.88,226336,62663,108954,272627,670580,1312,798,173,185,2468
1062,2017-03-27,56.9025,237438,66796,112920,283562,700716,1380,816,190,186,2572
1063,2017-03-28,57.0075,241486,70101,115321,286706,713614,1429,847,190,187,2653
1064,2017-03-29,56.61,247466,71092,117692,294066,730316,1463,896,191,191,2741
1065,2017-03-30,56.08,247343,69090,128703,306956,752092,1511,961,205,201,2878
1066,2017-03-31,56.28,254073,79934,134734,308873,777614,1566,986,212,208,2972
1067,2017-04-03,56.115,259847,80464,138082,317465,795858,1604,998,222,206,3030
1068,2017-04-04,56.09,262927,84242,138160,316845,802174,1632,1023,222,214,3091
1069,2017-04-05,56.38,259349,90170,146387,315566,811472,1687,1047,231,223,3188
1070,2017-04-06,56.3975,273588,92816,155218,335990,857612,1743,1049,234,230,3256
1071,2017-04-07,57.25,286855,102832,159477,343500,892664,1791,1066,245,229,3331
1072,2017-04-10,57.1675,298683,102853,161958,357788,921282,1867,1082,250,229,3428
1073,2017-04-11,56.8975,304708,109933,163779,358554,936974,1861,1099,257,233,3450
1074,2017-04-12,56.595,311057,110185,168501,369373,959116,1864,1110,260,237,3471
1075,2017-04-13,56.2825,323654,113364,173956,384246,995220,1843,1136,266,238,3483
1076,2017-04-14,56.3625,323162,119974,176482,379670,999288,1852,1161,260,237,3510
1077,2017-04-17,55.9425,322685,124439,182131,380377,1009632,1865,1183,267,241,3556
1078,2017-04-18,56.25,323665,124634,182668,381699,1012666,1851,1208,269,240,3568
1079,2017-04-19,56.5675,332435,129270,180734,383899,1026338,1908,1208,276,241,3633
1080,2017-04-20,56.1975,140946,70077,81881,152750,445654,925,588,135,134,1782
1081,2017-04-21,56.455,187532,95536,87268,179264,549600,1103,702,150,162,2117
1082,2017-04-24,55.8475,199160,91961,86941,194140,572202,1193,766,161,175,2295
1083,2017-04-25,56.1675,224361,97121,92634,219874,633990,1265,793,175,175,2408
1084,2017-04-26,57.16,243086,94890,98300,246496,682772,1431,801,173,185,2590
1085,2017-04-27,56.9725,266183,110240,120377,276320,773120,1498,831,179,191,2699
1086,2017-04-28,56.9225,274612,115927,125686,284371,800596,1542,863,191,185,2781
1087,2017-05-02,57.0,281664,120820,130990,291834,825308,1572,868,206,189,2835
1088,2017-05-03,57.3825,293529,119367,131765,305927,850588,1626,873,202,194,2895
1089,2017-05-04,58.3975,312686,117914,133192,327964,891756,1759,874,203,194,3030
1090,2017-05-05,57.9325,324757,132869,133867,325755,917248,1905,974,204,202,3285
1091,2017-05-10,57.435,337695,129048,123807,332454,923004,1907,985,208,199,3299
1092,2017-05-11,57.05,338162,129028,126729,335863,929782,1864,1022,212,199,3297
1093,2017-05-12,57.085,337565,128156,127463,336872,930056,1848,1034,207,208,3297
1094,2017-05-15,56.345,344012,139218,133079,337873,954182,1823,1076,211,204,3314
1095,2017-05-16,56.58,355672,137972,125835,343535,963014,1848,1097,214,201,3360
1096,2017-05-17,57.085,369474,138302,122608,353780,984164,1932,1110,210,214,3466
1097,2017-05-18,57.58,258444,84926,89662,263180,696212,1213,674,140,142,2169
1098,2017-05-19,56.9,263073,92147,93970,264896,714086,1288,767,150,142,2347
1099,2017-05-22,56.64,273195,103186,104352,274361,755094,1352,831,170,158,2511
1100,2017-05-23,56.36,275856,112763,108314,271407,768340,1379,898,181,166,2624
1101,2017-05-24,56.405,278653,113006,112189,277836,781684,1437,916,185,176,2714
1102,2017-05-25,56.96,285074,113940,117470,288604,805088,1460,939,196,177,2772
1103,2017-05-26,56.5,289216,109066,142711,322861,863854,1487,942,194,188,2811
1104,2017-05-29,56.45,295635,112676,161232,344191,913734,1535,969,199,193,2896
1105,2017-05-30,56.54,307229,114229,167558,360558,949574,1586,998,207,187,2978
1106,2017-05-31,56.56,311362,117477,170645,364530,964014,1614,1008,212,187,3021
1107,2017-06-01,56.385,319187,118932,173177,373432,984728,1605,1006,207,188,3006
1108,2017-06-02,56.6575,325678,122586,177752,380844,1006860,1644,1004,208,187,3043
1109,2017-06-05,56.6,330205,126377,182018,385846,1024446,1662,1013,211,192,3078
1110,2017-06-06,56.52,332837,129376,184180,387641,1034034,1701,1024,210,194,3129
1111,2017-06-07,57.0825,338345,133788,173275,377832,1023240,1757,1015,218,195,3185
1112,2017-06-08,56.9175,343080,132067,185580,396593,1057320,1779,1021,210,209,3219
1113,2017-06-09,57.03,345258,129985,184590,399863,1059696,1776,1020,215,205,3216
1114,2017-06-13,56.98,350441,131331,183736,402846,1068354,1805,1020,211,216,3252
1115,2017-06-14,57.435,366788,138112,186026,414702,1105628,1837,1056,221,229,3343
1116,2017-06-15,57.89,64799,41319,80079,103559,289756,541,385,95,106,1127
1117,2017-06-16,57.77,75969,45996,79845,109818,311628,699,485,107,132,1423
1118,2017-06-19,58.4425,86846,51174,83647,119319,340986,832,559,118,146,1655
1119,2017-06-20,59.6325,114207,67952,108230,154485,444874,1135,652,140,181,2108
1120,2017-06-21,60.3225,133879,87246,150384,197017,568526,1382,719,164,218,2483
1121,2017-06-22,59.9375,154457,93009,165422,226870,639758,1545,771,187,221,2724
1122,2017-06-23,59.385,167428,96903,181510,252035,697876,1561,783,190,222,2756
1123,2017-06-26,58.77,163649,100263,197663,261049,722624,1510,816,202,219,2747
1124,2017-06-27,59.49,174695,111496,200357,263556,750104,719,331,52,55,1157
1125,2017-06-28,59.2,177791,118375,210054,269470,775690,744,325,53,54,1176
1126,2017-06-29,59.425,186627,120952,218036,283711,809326,745,334,56,54,1189
1127,2017-06-30,58.93,186589,122389,219623,283823,812424,753,346,56,54,1209
1128,2017-07-03,59.265,185096,124250,223644,284490,817480,749,369,56,55,1229
1129,2017-07-04,59.4125,185501,126283,232680,291898,836362,768,374,55,56,1253
1130,2017-07-05,59.9825,193223,128818,241434,305839,869314,780,365,56,57,1258
1131,2017-07-06,60.16,198240,133326,252638,317552,901756,808,376,58,58,1300
1132,2017-07-07,60.355,208024,136337,250037,321724,916122,837,380,56,57,1330
1133,2017-07-10,60.23,208950,139016,252536,322470,922972,855,389,57,60,1361
1134,2017-07-11,60.76,224175,142383,255019,336811,958388,880,386,56,58,1380
1135,2017-07-12,60.005,235522,150357,269013,354178,1009070,860,410,57,61,1388
1136,2017-07-13,59.8225,235338,158655,277649,354332,1025974,860,424,58,62,1404
1137,2017-07-14,59.09,222712,161840,282761,343633,1010946,792,444,54,61,1351
1138,2017-07-17,59.3275,221094,164734,285369,341729,1012926,799,435,56,59,1349
1139,2017-07-18,59.18,220121,161372,283638,342387,1007518,785,442,54,60,1341
1140,2017-07-19,59.0,230281,167484,285099,347896,1030760,789,449,55,60,1353
1141,2017-07-20,58.935,74926,73427,202326,203825,554504,362,270,40,41,713
1142,2017-07-21,59.36,90213,80455,207448,217206,595322,423,324,45,47,839
1143,2017-07-24,60.005,113727,91276,219138,241589,665730,505,338,49,48,940
1144,2017-07-25,59.87,120184,95924,224088,248348,688544,539,354,48,51,992
1145,2017-07-26,59.3975,138384,100664,246305,284025,769378,584,364,50,52,1050
1146,2017-07-27,59.4975,147493,104835,247578,290236,790142,592,379,50,51,1072
1147,2017-07-28,59.565,155463,109117,254283,300629,819492,607,384,50,52,1093
1148,2017-07-31,59.78,166538,118644,245559,293453,824194,608,380,51,50,1089
1149,2017-08-01,60.35,170486,117704,244211,296993,829394,615,383,51,51,1100
1150,2017-08-02,60.59,186020,122381,273762,337401,919564,647,389,52,50,1138
1151,2017-08-03,60.36,186739,123596,274266,337409,922010,662,395,52,49,1158
1152,2017-08-04,59.97,188035,132443,282788,338380,941646,656,417,50,50,1173
1153,2017-08-07,60.0325,190841,136774,283426,337493,948534,678,440,50,51,1219
1154,2017-08-08,59.8175,193349,135603,281966,339712,950630,677,455,50,52,1234
1155,2017-08-09,59.9825,196802,136745,281651,341708,956906,677,458,50,52,1237
1156,2017-08-10,60.11,200442,138863,280451,342030,961786,682,461,52,50,1245
1157,2017-08-11,59.8625,202012,138500,280123,343635,964270,668,477,51,50,1246
1158,2017-08-14,59.87,214567,129378,269255,354444,967644,685,473,54,53,1265
1159,2017-08-15,59.7125,219103,128661,268868,359310,975942,682,471,55,52,1260
1160,2017-08-16,59.3775,224421,125378,269990,369033,988822,678,473,54,54,1259
1161,2017-08-17,59.225,124368,86323,248129,286174,744994,448,332,37,45,862
1162,2017-08-18,59.0,137339,94680,255109,297768,784896,497,391,38,47,973
1163,2017-08-21,59.145,136824,98100,256291,295015,786230,525,417,40,47,1029
1164,2017-08-22,59.07,142498,102051,255655,296102,796306,542,441,39,47,1069
1165,2017-08-23,59.065,145445,107146,256946,295245,804782,553,453,41,46,1093
1166,2017-08-24,59.1575,146647,105722,253459,294384,800212,570,471,46,47,1134
1167,2017-08-25,58.575,149786,105038,252067,296815,803706,571,481,47,48,1147
1168,2017-08-28,58.435,163114,107033,251086,307167,828400,579,487,46,51,1163
1169,2017-08-29,58.835,168489,110609,248743,306623,834464,604,491,47,50,1192
1170,2017-08-30,58.56,174008,110788,250847,314067,849710,595,502,47,51,1195
1171,2017-08-31,58.02,182044,115785,252839,319098,869766,577,504,47,53,1181
1172,2017-09-01,57.52,208777,128045,266403,347135,950360,578,515,45,50,1188
1173,2017-09-04,57.8475,217758,129399,316068,404427,1067652,606,506,50,51,1213
1174,2017-09-05,57.52,233454,136766,313029,409717,1092966,612,504,50,50,1216
1175,2017-09-06,57.35,239104,143676,316739,412167,1111686,615,506,51,51,1223
1176,2017-09-07,56.9,244722,137091,308452,416083,1106348,612,514,49,51,1226
1177,2017-09-08,57.3675,248857,138461,309156,419552,1116026,636,511,51,52,1250
1178,2017-09-11,57.22,249463,141645,311081,418899,1121088,650,515,50,52,1267
1179,2017-09-12,57.71,258361,141961,306634,423034,1129990,668,523,51,51,1293
1180,2017-09-13,57.96,269485,143138,318884,445231,1176738,691,529,52,53,1325
1181,2017-09-14,57.5,274002,141895,321012,453119,1190028,693,540,51,54,1338
1182,2017-09-15,57.69,282019,147746,328292,462565,1220622,709,539,52,52,1352
1183,2017-09-18,58.11,302086,151355,326212,476943,1256596,734,531,54,53,1372
1184,2017-09-19,58.1275,308780,154889,322791,476682,1263142,725,523,54,54,1356
1185,2017-09-20,58.1225,317758,161045,320365,477078,1276246,717,528,56,58,1359
1186,2017-09-21,57.9,109592,45556,123768,187804,466720,366,284,31,33,714
1187,2017-09-22,57.5,119067,53684,127395,192778,492924,429,373,36,36,874
1188,2017-09-25,57.555,129637,58485,130557,201709,520388,484,400,39,41,964
1189,2017-09-26,57.82,139651,61874,131811,209588,542924,536,421,39,41,1037
1190,2017-09-27,58.195,164925,76812,135602,223715,601054,602,427,42,42,1113
1191,2017-09-28,57.91,149441,71937,139846,217350,578574,531,395,38,40,1004
1192,2017-09-29,57.48,156791,72983,151062,234870,615706,537,427,41,42,1047
1193,2017-10-02,57.9125,176609,83839,154871,247641,662960,590,429,45,42,1106
1194,2017-10-03,57.9,190677,85471,160933,266139,703220,614,437,46,44,1141
1195,2017-10-04,57.6875,195068,83604,177006,288470,744148,602,443,47,44,1136
1196,2017-10-05,57.6975,195681,78742,181996,298935,755354,567,413,46,42,1068
1197,2017-10-06,58.19,216668,84364,184735,317039,802806,630,422,47,42,1141
1198,2017-10-09,58.33,225180,91033,185839,319986,822038,672,443,47,42,1204
1199,2017-10-10,57.9875,228748,93675,192900,327973,843296,640,465,47,42,1194
1200,2017-10-11,57.8375,236713,96750,195088,335051,863602,638,472,47,43,1200
1201,2017-10-12,57.6975,232522,95239,200455,337738,865954,586,465,47,41,1139
1202,2017-10-13,57.16,233502,100239,205692,338955,878388,572,501,48,42,1163
1203,2017-10-16,57.3175,238825,102985,207911,343751,893472,590,502,48,43,1183
1204,2017-10-17,57.2925,249658,106058,207034,350634,913384,618,511,47,47,1223
1205,2017-10-18,57.425,250124,110135,212993,352982,926234,630,519,47,46,1242
1206,2017-10-19,57.2725,106257,77103,159601,188755,531716,356,384,30,36,806
1207,2017-10-20,57.4825,127412,80621,167380,214171,589584,449,434,30,38,951
1208,2017-10-23,57.55,147634,86132,173906,235408,643080,500,458,31,38,1027
1209,2017-10-24,57.62,165059,94506,181035,251588,692188,525,462,34,40,1061
1210,2017-10-25,57.745,165260,96138,181050,250172,692620,540,468,34,40,1082
1211,2017-10-26,57.855,147408,92732,180282,234958,655380,445,434,34,39,952
1212,2017-10-27,58.06,162474,100740,187924,249658,700796,518,457,37,40,1052
1213,2017-10-30,57.9725,185852,104055,197284,279081,766272,527,476,37,39,1079
1214,2017-10-31,58.32,205795,107289,198029,296535,807648,606,471,41,42,1160
1215,2017-11-01,58.29,212956,110930,203261,305287,832434,600,480,41,47,1168
1216,2017-11-02,58.1625,195141,101350,205860,299651,802002,559,433,42,46,1080
1217,2017-11-03,59.08,216039,110590,233607,339056,899292,634,478,47,46,1205
1218,2017-11-07,59.365,257127,125163,250030,381994,1014314,671,458,47,46,1222
1219,2017-11-08,59.2275,269223,135129,251487,385581,1041420,703,464,47,48,1262
1220,2017-11-09,59.29,263337,134745,251256,379848,1029186,670,429,45,45,1189
1221,2017-11-10,59.22,271605,141170,255036,385471,1053282,696,456,48,46,1246
1222,2017-11-13,59.35,274885,138472,254373,390786,1058516,709,475,49,50,1283
1223,2017-11-14,60.2375,293014,154763,260542,398793,1107112,733,476,49,51,1309
1224,2017-11-15,60.215,304384,175788,297292,425888,1203352,744,497,51,54,1346
1225,2017-11-16,59.6775,119348,94820,233467,257995,705630,493,366,40,44,943
1226,2017-11-17,59.08,126104,101927,241417,265594,735042,541,478,43,47,1109
1227,2017-11-20,59.345,133061,106953,244483,270591,755088,568,505,43,47,1163
1228,2017-11-21,59.1775,141432,107090,249751,284093,782366,602,532,43,49,1226
1229,2017-11-22,58.485,149081,109882,250913,290112,799988,594,565,43,50,1252
1230,2017-11-23,58.45,141156,105774,241824,277206,765960,521,544,42,52,1159
1231,2017-11-24,58.37,148940,108478,241872,282334,781624,555,561,44,52,1212
1232,2017-11-27,58.4975,155038,109583,246305,291760,802686,580,580,44,53,1257
1233,2017-11-28,58.36,163024,110752,259700,311972,845448,608,590,46,53,1297
1234,2017-11-29,58.62,172295,111265,278506,339536,901602,619,595,47,57,1318
1235,2017-11-30,58.45,167910,113889,279752,333773,895324,563,560,47,56,1226
1236,2017-12-01,58.88,172497,117173,289613,344937,924220,614,588,46,55,1303
1237,2017-12-04,58.8075,181021,125126,288315,344210,938672,650,582,46,58,1336
1238,2017-12-05,58.75,186972,128935,288629,346666,951202,658,591,48,59,1356
1239,2017-12-06,59.23,199811,132930,290550,357431,980722,696,593,48,58,1395
1240,2017-12-07,59.1775,199408,136224,289801,352985,978418,663,551,49,57,1320
1241,2017-12-08,59.13,205807,142856,290761,353712,993136,703,579,48,55,1385
1242,2017-12-11,59.005,212761,147661,292786,357886,1011094,728,586,48,56,1418
1243,2017-12-12,59.285,223686,156036,297001,364651,1041374,733,582,48,55,1418
1244,2017-12-13,58.6125,225186,158017,301963,369132,1054298,722,588,51,52,1413
1245,2017-12-14,58.76,237154,151316,304578,390416,1083464,662,568,48,55,1333
1246,2017-12-15,58.8,241869,152222,303568,393215,1090874,689,588,49,56,1382
1247,2017-12-18,58.6625,247551,153519,311038,405070,1117178,699,582,49,58,1388
1248,2017-12-19,58.7625,260456,153953,311628,418131,1144168,695,571,47,55,1368
1249,2017-12-20,58.71,287868,149457,326407,464818,1228550,670,567,45,55,1337
1250,2017-12-21,58.4625,134010,41690,168447,260767,604914,294,268,22,35,619
1251,2017-12-22,58.375,157470,59503,177891,275858,670722,345,348,22,39,754
1252,2017-12-25,57.9625,174629,62085,186108,298652,721474,379,392,24,41,836
1253,2017-12-26,57.62,182135,69586,189870,302419,744010,389,415,24,41,869
1254,2017-12-27,57.745,211653,79591,202535,334597,828376,404,430,26,41,901
1255,2017-12-28,57.5025,212408,74144,201677,339941,828170,375,375,27,41,818
1256,2017-12-29,57.63,224334,84877,207932,347389,864532,393,399,27,42,861
1257,2018-01-03,57.22,239004,91387,207420,355037,892848,410,418,28,43,899
1258,2018-01-04,56.84,257146,92567,215429,380008,945150,411,425,26,43,905
1259,2018-01-05,56.9825,264332,94904,216587,386015,961838,427,432,27,43,929
1260,2018-01-09,56.995,276491,95888,220514,401117,994010,469,441,27,43,980
1261,2018-01-10,57.0325,295286,98696,224965,421555,1040502,508,455,27,43,1033
1262,2018-01-11,56.4275,294654,94309,226272,426617,1041852,493,427,28,44,992
1263,2018-01-12,56.65,296382,102797,224403,417988,1041570,507,446,30,45,1028
1264,2018-01-15,56.32,304259,106244,230389,428404,1069296,518,447,31,45,1041
1265,2018-01-16,56.53,308246,109789,231866,430323,1080224,537,455,31,46,1069
1266,2018-01-17,56.7525,309517,111860,226860,424517,1072754,557,457,31,44,1089
1267,2018-01-18,56.525,119884,53385,154524,221023,548816,393,285,25,35,738
1268,2018-01-19,56.72,124776,58083,155212,221905,559976,461,321,27,35,844
1269,2018-01-22,56.495,160655,61844,161892,260703,645094,494,349,27,36,906
1270,2018-01-23,56.35,174463,67734,164835,271564,678596,529,362,28,37,956
1271,2018-01-24,56.1725,201465,71598,170180,300047,743290,558,367,30,39,994
1272,2018-01-25,55.9275,212561,73722,182305,321144,789732,483,347,30,38,898
1273,2018-01-26,56.275,233706,76438,195444,352712,858300,533,388,30,39,990
1274,2018-01-29,56.32,260736,83544,199267,376459,920006,583,408,30,39,1060
1275,2018-01-30,56.385,269715,91308,204269,382676,947968,582,413,31,38,1064
1276,2018-01-31,56.2075,274726,94178,203862,384410,957176,601,424,31,39,1095
1277,2018-02-01,55.92,270512,90994,203511,383029,948046,559,392,31,40,1022
1278,2018-02-02,56.55,286898,98189,203329,392038,980454,599,413,31,41,1084
1279,2018-02-05,57.195,302620,99711,205105,408014,1015450,647,420,32,42,1141
1280,2018-02-06,56.855,320393,101313,200240,419320,1041266,675,417,31,44,1167
1281,2018-02-07,57.61,341630,112158,206649,436121,1096558,709,442,32,44,1227
1282,2018-02-08,58.4225,354636,116152,205310,443794,1119892,718,392,32,44,1186
1283,2018-02-09,58.4,379429,122262,225086,482253,1209030,776,434,32,44,1286
1284,2018-02-12,57.83,403737,125577,234903,513063,1277280,791,441,34,45,1311
1285,2018-02-13,57.63,414902,119779,244631,539754,1319066,807,451,35,46,1339
1286,2018-02-14,56.71,424695,127510,252564,549749,1354518,783,465,36,47,1331
1287,2018-02-15,56.3925,293151,79129,197457,411479,981216,510,332,32,37,911
1288,2018-02-16,56.3975,301423,79890,202009,423542,1006864,554,364,33,41,992
1289,2018-02-19,56.46,314031,82678,203335,434688,1034732,597,381,33,43,1054
1290,2018-02-20,56.565,339764,85575,202709,456898,1084946,615,395,34,44,1088
1291,2018-02-21,56.76,351326,86552,202222,466996,1107096,641,402,34,46,1123
1292,2018-02-22,56.5175,338533,89693,200208,449048,1077482,575,361,34,45,1015
1293,2018-02-26,55.705,352393,97628,200465,455230,1105716,612,374,36,45,1067
1294,2018-02-27,56.275,367432,100342,197256,464346,1129376,645,392,36,46,1119
1295,2018-02-28,56.3325,376485,101609,198616,473492,1150202,685,404,36,46,1171
1296,2018-03-01,56.8225,382166,103386,201451,480231,1167234,697,373,37,45,1152
1297,2018-03-02,56.815,404202,113947,204787,495042,1217978,750,381,38,45,1214
1298,2018-03-05,56.42,427321,123926,203729,507124,1262100,779,396,38,45,1258
1299,2018-03-06,56.67,438058,121885,203292,519465,1282700,739,412,38,44,1233
1300,2018-03-07,56.79,427136,125035,202753,504854,1259778,723,377,40,44,1184
1301,2018-03-09,56.66,441192,127217,202921,516896,1288226,740,394,40,44,1218
1302,2018-03-12,56.88,488643,133724,202450,557369,1382186,773,406,39,45,1263
1303,2018-03-13,57.02,504835,134574,203533,573794,1416736,774,406,39,45,1264
1304,2018-03-14,57.1225,515754,130175,205363,590942,1442234,784,380,40,46,1250
1305,2018-03-15,57.46,129837,31339,27034,125532,313742,446,188,23,27,684
1306,2018-03-16,57.49,158199,40894,26381,143686,369160,575,232,23,27,857
1307,2018-03-19,57.84,201682,63626,36168,174224,475700,668,256,25,28,977
1308,2018-03-20,57.53,215915,73165,43793,186543,519416,672,285,27,28,1012
1309,2018-03-21,56.88,228317,78078,50552,200791,557738,698,296,30,29,1053
1310,2018-03-22,57.245,201775,67073,49232,183934,502014,549,280,27,28,884
1311,2018-03-23,57.29,216682,69702,61209,208189,555782,615,310,29,30,984
1312,2018-03-26,57.1625,221027,78617,71385,213795,584824,642,322,29,31,1024
1313,2018-03-27,57.5125,236590,80886,76452,232156,626084,690,330,31,31,1082
1314,2018-03-28,57.7225,258567,83464,72962,248065,663058,719,325,31,30,1105
1315,2018-03-29,57.2575,248829,80666,83135,251298,663928,631,304,31,29,995
1316,2018-03-30,57.145,261618,85971,78280,253927,679796,664,337,32,30,1063
1317,2018-04-02,57.4825,275842,90702,78787,263927,709258,711,353,33,30,1127
1318,2018-04-03,57.57,284056,98692,79898,265262,727908,727,351,32,30,1140
1319,2018-04-04,57.445,292502,99709,82891,275684,750786,752,355,32,30,1169
1320,2018-04-05,57.71,281221,93626,76796,264391,716034,680,321,33,30,1064
1321,2018-04-06,58.175,308554,96152,87731,300133,792570,727,342,34,30,1133
1322,2018-04-09,60.66,380276,125893,121137,375520,1002826,866,304,34,29,1233
1323,2018-04-10,63.0225,422422,169222,134949,388149,1114742,1029,305,36,30,1400
1324,2018-04-11,62.59,446959,184088,135640,398511,1165198,1154,325,37,31,1547
1325,2018-04-12,61.99,412620,178188,145553,379985,1116346,963,315,35,31,1344
1326,2018-04-13,62.05,429653,186095,143875,387433,1147056,967,353,36,34,1390
1327,2018-04-16,61.165,430872,188879,148106,390099,1157956,991,364,36,34,1425
1328,2018-04-17,61.5575,439893,194595,148695,393993,1177176,997,387,36,33,1453
1329,2018-04-18,60.85,444278,194865,148283,397696,1185122,1002,393,36,34,1465
1330,2018-04-19,60.8925,167289,71967,50478,145800,435534,561,220,30,29,840
1331,2018-04-20,61.4,179190,84493,52043,146740,462466,645,291,32,29,997
1332,2018-04-23,61.805,203786,87342,60415,176859,528402,740,303,32,30,1105
1333,2018-04-24,61.62,214380,89902,64233,188711,557226,778,309,33,31,1151
1334,2018-04-25,62.365,246708,96718,64230,214220,621876,822,307,34,30,1193
1335,2018-04-26,62.72,232704,88289,69121,213536,603650,752,262,34,30,1078
1336,2018-04-27,62.155,249066,97626,75051,226491,648234,810,310,35,33,1188
1337,2018-04-28,62.27,260737,99106,75567,237198,672608,817,323,35,34,1209
1338,2018-04-30,62.9675,270479,101048,76182,245613,693322,855,326,36,34,1251
1339,2018-05-02,64.02,305531,113082,79510,271959,770082,939,310,37,32,1318
1340,2018-05-03,63.025,302115,102141,81428,281402,767086,853,276,37,32,1198
1341,2018-05-04,62.505,316906,109894,84623,291635,803058,889,327,38,33,1287
1342,2018-05-07,62.9325,331500,111188,84524,304836,832048,936,344,38,33,1351
1343,2018-05-08,63.225,353906,113792,81811,321925,871434,974,338,39,32,1383
1344,2018-05-10,61.71,318557,110038,80337,288856,797788,861,317,36,30,1244
1345,2018-05-11,61.93,309836,117240,83080,275676,785832,872,352,37,32,1293
1346,2018-05-14,61.85,317198,121726,85186,280658,804768,892,359,38,33,1322
1347,2018-05-15,62.3175,349829,132311,84901,302419,869460,929,354,38,34,1355
1348,2018-05-16,61.73,348794,143508,87775,293061,873138,924,363,38,33,1358
1349,2018-05-17,62.185,233154,88155,63948,208947,594204,720,271,35,31,1057
1350,2018-05-18,62.2575,250970,101888,68294,217376,638528,792,313,35,34,1174
1351,2018-05-21,61.6,259670,109233,70336,220773,660012,783,339,36,34,1192
1352,2018-05-22,61.21,258002,112279,76534,222257,669072,787,370,37,35,1229
1353,2018-05-23,61.33,267408,115213,77308,229503,689432,820,381,39,38,1278
1354,2018-05-24,61.6,245369,100658,74673,219384,640084,742,312,40,36,1130
1355,2018-05-25,62.2875,279122,107319,77866,249669,713976,809,337,47,38,1231
1356,2018-05-28,62.32,293683,106845,77839,264677,743044,859,340,42,38,1279
1357,2018-05-29,62.815,315226,121443,82695,276478,795842,886,352,41,40,1319
1358,2018-05-30,62.075,311304,123449,87788,275643,798184,875,372,43,42,1332
1359,2018-05-31,62.405,289514,114454,84986,260046,749000,776,336,40,37,1189
1360,2018-06-01,62.1925,298241,119061,88869,268049,774220,803,387,44,41,1275
1361,2018-06-04,62.0575,307110,122191,93463,278382,801146,838,412,45,41,1336
1362,2018-06-05,62.15,321522,126094,94461,289889,831966,857,415,45,41,1358
1363,2018-06-06,61.7675,333616,127600,101204,307220,869640,866,419,45,42,1372
1364,2018-06-07,62.4175,320109,123727,98167,294549,836552,804,360,45,42,1251
1365,2018-06-08,62.31,332009,129732,95484,297761,854986,832,393,45,41,1311
1366,2018-06-09,62.525,333754,129939,93808,297623,855124,837,404,45,40,1326
1367,2018-06-11,62.8175,336106,131192,92197,297111,856606,862,413,45,40,1360
1368,2018-06-13,62.535,351988,144972,97825,304841,899626,851,421,45,41,1358
1369,2018-06-14,62.63,344985,136210,92954,301729,875878,784,371,44,42,1241
1370,2018-06-15,63.1975,366266,146354,89207,309119,910946,841,403,44,43,1331
1371,2018-06-18,63.4525,392371,153930,91865,330306,968472,886,396,46,44,1372
1372,2018-06-19,63.875,460041,175493,108790,393338,1137662,934,398,49,48,1429
1373,2018-06-20,63.69,471973,180495,122509,413987,1188964,945,397,48,48,1438
1374,2018-06-21,63.715,74571,28886,29384,75069,207910,408,223,29,30,690
1375,2018-06-22,62.895,87472,43403,39216,83285,253376,420,296,31,31,778
1376,2018-06-25,62.7825,103717,47676,51610,107651,310654,473,332,33,33,871
1377,2018-06-26,63.0275,116632,50395,51814,118051,336892,496,343,33,36,908
1378,2018-06-27,63.23,133886,58357,50687,126216,369146,530,346,33,38,947
1379,2018-06-28,62.8,116035,48077,44574,112532,321218,427,288,31,37,783
1380,2018-06-29,62.77,128832,54903,47051,120980,351766,470,353,30,36,889
1381,2018-07-02,63.43,145122,58941,48698,134879,387640,547,357,30,36,970
1382,2018-07-03,63.145,150093,64808,50707,135992,401600,551,358,30,36,975
1383,2018-07-04,63.24,157140,69317,50666,138489,415612,572,368,31,37,1008
1384,2018-07-05,63.115,128886,57340,47969,119515,353710,489,302,29,33,853
1385,2018-07-06,62.9725,133336,60428,48301,121209,363274,524,355,31,35,945
1386,2018-07-09,62.485,141027,63314,44239,121952,370532,540,382,33,34,989
1387,2018-07-10,61.735,153206,69121,46877,130962,400166,527,395,31,34,987
1388,2018-07-11,62.3575,160405,69570,50578,141413,421966,540,411,31,35,1017
1389,2018-07-12,62.255,138073,63814,49678,123937,375502,494,341,29,32,896
1390,2018-07-13,62.56,148046,65273,50994,133767,398080,541,369,30,32,972
1391,2018-07-16,62.33,164095,77093,52836,139838,433862,553,392,34,32,1011
1392,2018-07-17,62.6,161491,75796,58627,144322,440236,580,388,35,35,1038
1393,2018-07-18,62.9625,179477,86973,61423,153927,481800,647,375,34,36,1092
1394,2018-07-19,63.6625,49809,39353,26518,36974,152654,418,233,25,24,700
1395,2018-07-20,63.515,62777,46873,32777,48681,191108,509,297,24,27,857
1396,2018-07-23,63.0675,69688,49992,31026,50722,201428,519,332,27,28,906
1397,2018-07-24,63.325,73175,56434,33972,50713,214294,512,366,26,32,936
1398,2018-07-25,62.82,77003,63385,40589,54207,235184,549,374,27,33,983
1399,2018-07-26,62.955,64180,58914,41654,46920,211668,444,309,24,30,807
1400,2018-07-27,62.7975,74004,62249,43686,55441,235380,479,360,25,33,897
1401,2018-07-30,62.2375,76761,64601,39599,51759,232720,486,402,23,32,943
1402,2018-07-31,62.5025,80440,66622,39178,52996,239236,516,416,24,32,988
1403,2018-08-01,63.045,87618,70666,43867,60819,262970,555,413,25,31,1024
1404,2018-08-02,63.405,89309,64263,42062,67108,262742,518,346,27,31,922
1405,2018-08-03,63.3375,100562,69267,41402,72697,283928,602,398,25,33,1058
1406,2018-08-06,63.74,116117,72734,42968,86351,318170,674,400,27,33,1134
1407,2018-08-07,63.49,119142,74672,44034,88504,326352,698,415,28,33,1174
1408,2018-08-08,65.5475,155664,105128,51500,102036,414328,819,411,29,33,1292
1409,2018-08-09,66.65,183360,117612,52135,117883,470990,808,373,28,34,1243
1410,2018-08-10,67.72,236891,164676,83377,155592,640536,993,398,30,35,1456
1411,2018-08-13,67.8,260805,184121,94911,171595,711432,1079,422,30,35,1566
1412,2018-08-14,66.34,278511,190432,95284,183363,747590,1053,438,32,36,1559
1413,2018-08-15,67.29,292660,192230,92689,193119,770698,1071,435,32,36,1574
1414,2018-08-16,66.8425,110781,94048,56486,73219,334534,677,330,23,28,1058
1415,2018-08-17,67.03,123669,102024,59461,81106,366260,764,373,25,34,1196
1416,2018-08-20,67.1075,145904,114194,69310,101020,430428,816,390,27,35,1268
1417,2018-08-21,67.275,162601,117929,75884,120556,476970,870,398,27,36,1331
1418,2018-08-22,68.03,182853,130652,75449,127650,516604,938,410,28,36,1412
1419,2018-08-23,68.19,172239,121236,64612,115615,473702,843,364,29,33,1269
1420,2018-08-24,67.1,182592,134092,74100,122600,513384,900,421,31,36,1388
1421,2018-08-27,67.52,190616,143831,82999,129784,547230,877,457,31,37,1402
1422,2018-08-28,67.87,218028,146240,88751,160539,613558,932,453,31,37,1453
1423,2018-08-29,67.94,242724,157960,91101,175865,667650,1020,452,32,36,1540
1424,2018-08-30,68.2375,209801,137363,78836,151274,577274,891,369,32,33,1325
1425,2018-08-31,67.55,245712,166037,91246,170921,673916,894,456,32,34,1416
1426,2018-09-03,68.12,286957,166949,98915,218923,771744,966,462,33,33,1494
1427,2018-09-04,68.11,310589,176268,108822,243143,838822,1001,466,34,33,1534
1428,2018-09-05,68.25,333156,188962,118089,262283,902490,1046,479,34,36,1595
1429,2018-09-06,69.255,327107,181933,102720,247894,859654,945,413,34,34,1426
1430,2018-09-07,69.9125,363997,202374,125253,286876,978500,1011,482,34,37,1564
1431,2018-09-10,70.565,420759,229256,156650,348153,1154818,1086,479,37,37,1639
1432,2018-09-11,69.41,436093,235284,164711,365520,1201608,1106,504,38,40,1688
1433,2018-09-12,69.0325,437075,233924,177738,380889,1229626,1062,512,38,39,1651
1434,2018-09-13,68.25,409386,222590,179950,366746,1178672,911,439,35,35,1420
1435,2018-09-14,68.0525,421473,227608,204052,397917,1251050,948,495,36,35,1514
1436,2018-09-17,68.0625,438639,238706,223215,423148,1323708,979,509,36,35,1559
1437,2018-09-18,67.3725,442674,232990,256901,466585,1399150,968,514,37,35,1554
1438,2018-09-19,66.83,422348,211093,242880,454135,1330456,936,509,40,39,1524
1439,2018-09-20,66.26,62647,35837,30413,57223,186120,391,295,21,24,731
1440,2018-09-21,66.41,76932,45132,33756,65556,221376,454,354,22,23,853
1441,2018-09-24,65.835,87050,54655,42933,75328,259966,505,387,25,27,944
1442,2018-09-25,65.8925,96343,59987,48044,84400,288774,520,398,24,25,967
1443,2018-09-26,65.8,103631,65960,54486,92157,316234,554,411,24,26,1015
1444,2018-09-27,65.6225,89692,42920,39023,85795,257430,482,313,21,22,838
1445,2018-09-28,65.535,97160,46520,42396,93036,279112,545,355,24,23,947
1446,2018-10-01,65.0,99003,53713,50423,95713,298852,570,379,24,24,997
1447,2018-10-02,65.5,111469,56211,59034,114292,341006,595,392,25,25,1037
1448,2018-10-03,65.8625,124283,64187,73081,133177,394728,633,397,25,24,1079
1449,2018-10-04,67.0175,123744,54662,65335,134417,378158,558,319,22,22,921
1450,2018-10-05,66.5975,131838,66048,80139,145929,423954,621,376,23,27,1047
1451,2018-10-08,66.5575,141291,82217,106594,165668,495770,637,400,26,31,1094
1452,2018-10-09,66.25,144189,84396,107067,166860,502512,658,412,26,31,1127
1453,2018-10-10,66.9,162287,80456,115831,197662,556236,683,425,29,31,1168
1454,2018-10-11,66.27,143325,57027,81846,168144,450342,592,363,27,27,1009
1455,2018-10-12,66.1175,142416,77236,115758,180938,516348,619,415,28,27,1089
1456,2018-10-15,65.65,144853,92812,150982,203023,591670,604,455,26,25,1110
1457,2018-10-16,65.3075,151931,100815,168401,219517,640664,610,462,30,29,1131
1458,2018-10-17,65.4975,163491,111690,163769,215570,654520,625,471,32,28,1156
1459,2018-10-18,65.82,75023,53602,62862,84283,275770,408,282,24,25,739
1460,2018-10-19,65.49,84724,72521,96202,108405,361852,472,358,26,26,882
1461,2018-10-22,65.25,95776,85289,112603,123090,416758,495,397,28,26,946
1462,2018-10-23,65.5125,97493,97934,128580,128139,452146,512,411,28,26,977
1463,2018-10-24,65.685,101449,102119,142172,141502,487242,535,429,32,28,1024
1464,2018-10-25,65.5925,82832,60105,66756,89483,299176,459,334,26,25,844
1465,2018-10-26,65.72,98182,68517,70388,100053,337140,505,367,27,27,926
1466,2018-10-29,65.85,102004,75203,72801,99602,349610,524,401,28,27,980
1467,2018-10-30,65.56,107112,79100,73381,101393,360986,539,422,29,29,1019
1468,2018-10-31,65.875,117150,84232,78730,111648,391760,576,429,29,31,1065
1469,2018-11-01,65.72,96896,81803,77179,92272,348150,512,405,27,31,975
1470,2018-11-02,66.2025,116770,92719,97256,121307,428052,585,448,30,30,1093
1471,2018-11-06,66.11,121502,109802,121405,133105,485814,600,487,30,35,1152
1472,2018-11-07,66.32,132991,114221,135262,154032,536506,615,501,31,35,1182
1473,2018-11-08,66.9025,120553,104644,139882,155791,520870,567,425,28,30,1050
1474,2018-11-09,68.005,142706,137978,169555,174283,624522,636,461,29,34,1160
1475,2018-11-12,67.845,155578,153197,182557,184938,676270,652,485,29,36,1202
1476,2018-11-13,68.13,165226,163954,202228,203500,734908,680,488,30,35,1233
1477,2018-11-14,67.02,169091,167408,208159,209842,754500,683,514,30,38,1265
1478,2018-11-15,65.8975,96746,98475,76004,74275,345500,482,353,25,25,885
1479,2018-11-16,65.98,103801,105488,85696,84009,378994,515,447,27,28,1017
1480,2018-11-19,65.55,110721,119145,104586,96162,430614,546,479,27,29,1081
1481,2018-11-20,66.165,115512,120906,112529,107135,456082,567,499,28,31,1125
1482,2018-11-21,65.66,121402,121015,112307,112694,467418,587,527,29,35,1178
1483,2018-11-22,65.62,104354,96888,79979,87445,368666,534,400,26,33,993
1484,2018-11-23,66.1925,124898,119814,128175,133259,506146,564,456,28,33,1081
1485,2018-11-26,67.1025,139184,125983,140341,153542,559050,641,460,30,34,1165
1486,2018-11-27,67.1075,145293,132801,148059,160551,586704,663,480,31,34,1208
1487,2018-11-28,66.955,158428,135661,145923,168690,608702,736,475,32,34,1277
1488,2018-11-29,66.21,128811,118422,98430,108819,454482,576,411,29,34,1050
1489,2018-11-30,66.95,155041,151613,146076,149504,602234,647,467,30,36,1180
1490,2018-12-03,66.5275,160397,161139,155046,154304,630886,682,493,31,38,1244
1491,2018-12-04,66.82,168880,159813,159850,168917,657460,694,509,32,39,1274
1492,2018-12-05,66.57,174267,160335,159826,173758,668186,706,504,33,39,1282
1493,2018-12-06,66.8675,146932,143406,136686,140212,567236,626,442,31,40,1139
1494,2018-12-07,66.395,156402,160920,146697,142179,606198,635,527,33,41,1236
1495,2018-12-10,66.6425,169996,158745,152551,163802,645094,671,538,34,42,1285
1496,2018-12-11,66.3525,176630,175304,174117,175443,701494,686,557,34,43,1320
1497,2018-12-12,66.3825,179197,181197,180489,178489,719372,695,561,34,43,1333
1498,2018-12-13,66.235,176526,173983,158663,161206,670378,643,462,33,39,1177
1499,2018-12-14,66.76,187808,179241,167202,175769,710020,688,511,33,40,1272
1500,2018-12-14,66.76,187808,179241,167202,175769,710020,688,511,33,40,1272
1501,2018-12-17,66.78,182888,177924,162696,167660,691168,661,513,31,41,1246
1502,2018-12-18,67.2825,175682,181074,164910,159518,681184,687,517,32,40,1276
1503,2018-12-19,67.46,195387,209080,202524,188831,795822,727,492,34,40,1293
1504,2018-12-20,68.2925,78422,91705,68985,55702,294814,380,273,24,28,705
1505,2018-12-21,68.84,108739,108521,75179,75397,367836,517,324,25,30,896
1506,2018-12-24,68.5825,135728,129841,77823,83710,427102,570,367,28,29,994
1507,2018-12-25,68.665,142332,144479,88571,86424,461806,602,383,29,29,1043
1508,2018-12-26,68.695,172933,166241,93493,100185,532852,675,394,32,29,1130
1509,2018-12-27,69.56,163810,116473,54946,102283,437512,579,293,32,26,930
1510,2018-12-28,69.5175,174324,125960,66557,114921,481762,611,354,30,28,1023
1511,2018-12-29,69.8175,179278,133780,72738,118236,504032,614,397,29,28,1068
1512,2019-01-03,68.64,183195,136027,79190,126358,524770,627,438,30,30,1125
1513,2019-01-04,67.74,193787,132578,83069,144278,553712,584,474,30,30,1118
1514,2019-01-08,66.885,208595,136646,86997,158946,591184,569,516,30,31,1146
1515,2019-01-09,66.745,215569,140938,88865,163496,608868,587,540,31,31,1189
1516,2019-01-10,66.91,201787,128380,88217,161624,580008,531,430,29,28,1018
1517,2019-01-11,66.875,206908,131813,89372,164467,592560,570,483,29,29,1111
1518,2019-01-14,67.075,204740,141035,93188,156893,595856,583,510,32,31,1156
1519,2019-01-15,66.96,201425,142335,94652,153742,592154,608,547,32,31,1218
1520,2019-01-16,66.3675,209959,145543,95800,160216,611518,626,560,31,33,1250
1521,2019-01-17,66.37,92044,51559,27269,67754,238626,415,360,22,30,827
1522,2019-01-18,66.275,104762,69485,43080,78357,295684,485,434,25,31,975
1523,2019-01-21,66.39,111422,92307,64653,83768,352150,514,490,29,33,1066
1524,2019-01-22,66.535,113096,95586,66534,84044,359260,532,513,29,33,1107
1525,2019-01-23,66.0725,122184,95095,66451,93540,377270,520,527,29,35,1111
1526,2019-01-24,65.7775,103965,59328,48443,93080,304816,477,424,25,29,955
1527,2019-01-25,66.0,117563,69974,51506,99095,338138,533,468,26,30,1057
1528,2019-01-28,66.26,129422,79069,52109,102462,363062,547,496,26,30,1099
1529,2019-01-29,66.05,139123,87976,54867,106014,387980,551,537,28,31,1147
1530,2019-01-30,65.505,153648,96604,55579,112623,418454,580,559,28,31,1198
1531,2019-01-31,65.4,137259,82640,60103,114722,394724,530,467,28,30,1055
1532,2019-02-01,65.505,159771,98170,60645,122246,440832,571,527,29,32,1159
1533,2019-02-04,65.59,165440,102963,61598,124075,454076,616,536,29,32,1213
1534,2019-02-05,65.62,168711,105858,61832,124685,461086,631,555,31,32,1249
1535,2019-02-06,65.87,181815,115008,63758,130565,491146,652,572,30,35,1289
1536,2019-02-07,65.9075,153102,90676,61745,124171,429694,581,503,30,30,1144
1537,2019-02-08,65.81,163293,99920,63654,127027,453894,598,570,31,32,1231
1538,2019-02-11,65.85,164893,112437,88794,141250,507374,609,580,33,34,1256
1539,2019-02-12,65.885,174658,118199,93612,150071,536540,620,600,34,36,1290
1540,2019-02-13,66.515,184744,122823,94321,156242,558130,632,610,33,38,1313
1541,2019-02-14,66.645,165932,103768,94836,157000,521536,625,507,34,34,1200
1542,2019-02-15,66.3,171564,115753,100138,155949,543404,670,563,33,35,1301
1543,2019-02-18,66.28,177543,125270,116284,168557,587654,668,573,33,38,1312
1544,2019-02-19,65.7625,204330,135740,118591,187181,645842,666,589,33,40,1328
1545,2019-02-20,65.6325,212504,141059,124776,196221,674560,658,598,33,42,1331
1546,2019-02-21,65.57,159029,82936,63359,139452,444776,525,414,26,33,998
1547,2019-02-22,65.3925,169640,92721,64045,140964,467370,555,487,29,34,1105
1548,2019-02-25,65.49,191281,97068,64503,158716,511568,598,523,29,34,1184
1549,2019-02-26,65.7,253188,141190,93766,205764,693908,604,546,30,35,1215
1550,2019-02-27,65.79,258017,141817,94266,210466,704566,650,572,30,39,1291
1551,2019-02-28,65.905,173409,89201,57763,141971,462344,572,476,28,33,1109
1552,2019-03-01,65.94,177136,97724,65269,144681,484810,605,540,28,35,1208
1553,2019-03-04,65.74,180902,96462,61884,146324,485572,617,542,28,35,1222
1554,2019-03-05,65.75,191301,109410,79632,161523,541866,638,570,29,38,1275
1555,2019-03-06,65.98,201431,132046,104212,173597,611286,652,581,30,38,1301
1556,2019-03-07,66.2825,185408,122038,104190,167560,579196,576,504,30,34,1144
1557,2019-03-11,65.97,192510,131513,119978,180975,624976,627,550,30,36,1243
1558,2019-03-12,65.635,204924,138912,121810,187822,653468,624,573,31,39,1267
1559,2019-03-13,65.4,221625,143291,121915,200249,687080,630,596,31,39,1296
1560,2019-03-14,65.5125,202460,128891,123558,197127,652036,594,537,31,32,1194
1561,2019-03-15,64.815,206058,134735,128136,199459,668388,627,594,31,34,1286
1562,2019-03-18,64.365,218113,136405,127608,209316,691442,620,592,32,43,1287
1563,2019-03-19,64.39,219256,139246,130854,210864,700220,653,594,33,43,1323
1564,2019-03-20,63.8675,239478,146515,146187,239150,771330,691,598,33,42,1364
1565,2019-03-21,63.87,111338,64743,41053,87648,304782,401,326,22,27,776
1566,2019-03-22,64.66,137247,84822,50177,102602,374848,511,385,25,30,951
1567,2019-03-25,64.085,156716,111631,71205,116290,455842,532,431,25,32,1020
1568,2019-03-26,64.4,173917,116748,70640,127809,489114,560,452,25,32,1069
1569,2019-03-27,64.835,206258,121033,73580,158805,559676,631,459,26,33,1149
1570,2019-03-28,64.94,178834,84238,57101,151697,471870,537,363,24,30,954
1571,2019-03-29,65.6375,193396,109883,79113,162626,545018,603,443,27,32,1105
1572,2019-04-01,65.1725,218308,123545,80998,175761,598612,658,481,28,32,1199
1573,2019-04-02,65.2975,222648,130114,83530,176064,612356,689,494,29,32,1244
1574,2019-04-03,65.24,236067,136332,86563,186298,645260,687,507,29,35,1258
1575,2019-04-04,65.475,216873,89372,49358,176859,532462,579,392,27,29,1027
1576,2019-04-05,65.34,226916,116924,70791,180783,595414,620,460,30,33,1143
1577,2019-04-08,64.8775,238510,136547,96480,198443,669980,642,486,31,33,1192
1578,2019-04-09,64.92,243214,137735,103754,209233,693936,655,514,30,33,1232
1579,2019-04-10,64.2925,247588,140485,105913,213016,707002,651,529,31,34,1245
1580,2019-04-11,64.61,227858,106079,77422,199201,610560,584,428,30,27,1069
1581,2019-04-12,64.35,239198,109677,84422,213943,647240,610,482,31,29,1152
1582,2019-04-15,64.26,253874,122404,84369,215839,676486,632,505,31,31,1199
1583,2019-04-16,64.09,254691,122768,85320,217243,680022,640,506,32,31,1209
1584,2019-04-17,63.845,258725,125766,86824,219783,691098,641,518,33,30,1222
1585,2019-04-18,63.8925,162010,63397,40258,138871,404536,451,333,24,23,831
1586,2019-04-19,64.05,169092,81631,69349,156810,476882,506,405,29,28,968
1587,2019-04-22,63.82,173217,93368,77632,157481,501698,536,437,31,29,1033
1588,2019-04-23,63.6875,172510,97961,85490,160039,516000,557,449,30,28,1064
1589,2019-04-24,64.3225,188919,116479,96832,169272,571502,590,458,30,30,1108
1590,2019-04-25,64.655,184299,76758,42926,150467,454450,533,378,26,25,962
1591,2019-04-26,64.735,191985,80201,44747,156531,473464,582,425,27,25,1059
1592,2019-04-29,64.4575,194400,83109,51666,162957,492132,592,443,29,27,1091
1593,2019-04-30,64.6225,201619,90847,51167,161939,505572,605,457,29,29,1120
1594,2019-05-02,65.4375,206610,89228,52663,170045,518546,574,381,28,26,1009
1595,2019-05-03,65.0775,208674,92419,54413,170668,526174,615,411,29,27,1082
1596,2019-05-06,65.2275,210397,95483,55471,170385,531736,624,433,29,27,1113
1597,2019-05-07,65.4075,216631,102407,57679,171903,548620,641,450,30,28,1149
1598,2019-05-08,65.0725,203758,101016,61344,164086,530204,554,411,28,26,1019
1599,2019-05-10,65.075,211438,106266,60556,165728,543988,581,428,29,28,1066
1600,2019-05-13,65.43,216279,108230,59698,167747,551954,618,433,31,30,1112
1601,2019-05-14,64.97,220995,114677,61414,167732,564818,619,440,31,29,1119
1602,2019-05-15,64.65,219692,118693,67097,168096,573578,608,451,32,32,1123
1603,2019-05-16,64.65,170895,83496,40223,127622,422236,485,356,22,25,888
1604,2019-05-17,64.7775,181167,92413,42898,131652,448130,541,410,24,25,1000
1605,2019-05-20,64.525,187593,99732,44910,132771,465006,566,423,24,25,1038
1606,2019-05-21,64.41,193050,104458,45404,133996,476908,587,433,25,27,1072
1607,2019-05-22,64.39,201126,107614,44504,138016,491260,586,443,25,29,1083
1608,2019-05-23,64.855,190222,98885,42555,133892,465554,506,375,22,25,928
1609,2019-05-24,64.4725,196271,106210,46556,136617,485654,527,432,24,29,1012
1610,2019-05-27,64.4575,197388,108864,50419,138943,495614,560,441,25,28,1054
1611,2019-05-28,64.715,201645,100061,50366,151950,504022,566,443,24,29,1062
1612,2019-05-29,64.97,213771,106652,50801,157920,529144,657,433,24,30,1144
1613,2019-05-30,65.17,199950,97653,45468,147765,490836,549,377,20,24,970
1614,2019-05-31,65.43,201694,101019,49946,150621,503280,590,412,21,30,1053
1615,2019-06-03,65.34,212204,108232,55093,159065,534594,632,423,23,30,1108
1616,2019-06-04,65.165,208723,106030,55875,158568,529196,635,430,23,30,1118
1617,2019-06-05,65.395,216296,107094,57986,167188,548564,664,439,24,32,1159
1618,2019-06-06,65.085,212614,98056,53759,168317,532746,572,381,23,28,1004
1619,2019-06-07,64.805,226851,102030,57147,181968,567996,603,420,24,30,1077
1620,2019-06-10,64.78,244494,105818,60138,198814,609264,610,448,24,31,1113
1621,2019-06-11,64.5575,246532,106282,59824,200074,612712,616,461,24,34,1135
1622,2019-06-13,64.58,240406,103124,61675,198957,604162,570,409,23,27,1029
1623,2019-06-14,64.38,239205,106613,65341,197933,609092,587,440,25,26,1078
1624,2019-06-17,64.32,246871,115753,67933,199051,629608,588,442,25,28,1083
1625,2019-06-18,64.02,259890,118805,72939,214024,665658,571,451,28,28,1078
1626,2019-06-19,63.785,296316,129744,74705,241277,742042,589,458,28,28,1103
1627,2019-06-20,62.89,213593,61030,32852,185415,492890,329,286,20,24,659
1628,2019-06-21,63.025,247456,71648,43340,219148,581592,392,325,23,26,766
1629,2019-06-24,62.6,286557,85769,67763,268551,708640,433,360,24,26,843
1630,2019-06-25,62.835,309701,85393,81845,306153,783092,496,389,24,26,935
1631,2019-06-26,63.0725,324147,99548,87484,312083,823262,543,406,25,26,1000
1632,2019-06-27,63.0725,309366,84414,84197,309149,787126,487,316,22,25,850
1633,2019-06-28,63.24,399944,97801,102625,404768,1005138,543,359,24,26,952
1634,2019-07-01,62.96,440513,110554,106438,436397,1093902,589,386,27,28,1030
1635,2019-07-02,63.32,447466,114713,107382,440135,1109696,620,395,27,28,1070
1636,2019-07-03,63.32,454561,118035,108266,444792,1125654,641,398,28,28,1095
1637,2019-07-04,63.48,445966,109398,108469,445037,1108870,562,332,26,28,948
1638,2019-07-05,63.8025,452508,122950,125531,455089,1156078,620,375,28,29,1052
1639,2019-07-08,63.695,459980,125165,126419,461234,1172798,653,392,28,30,1103
1640,2019-07-09,63.915,474533,140053,139194,473674,1227454,668,401,28,30,1127
1641,2019-07-10,63.18,479561,146781,141606,474386,1242334,657,416,27,30,1130
1642,2019-07-11,62.815,488355,133199,140153,495309,1257016,600,363,26,29,1018
1643,2019-07-12,62.9775,491500,136650,140617,495467,1264234,635,404,28,29,1096
1644,2019-07-15,62.67,499463,151687,158705,506481,1316336,647,408,28,31,1114
1645,2019-07-16,63.045,499135,160571,171036,509600,1340342,671,420,28,32,1151
1646,2019-07-17,62.935,505361,165723,173903,513541,1358528,678,423,30,33,1164
1647,2019-07-18,62.8075,271208,119621,94753,246340,731922,457,284,26,26,793
1648,2019-07-19,63.055,301643,134828,101972,268787,807230,537,357,29,26,949
1649,2019-07-22,63.095,306078,139374,113521,280225,839198,566,390,30,27,1013
1650,2019-07-23,63.16,310882,143371,115178,282689,852120,598,403,30,27,1058
1651,2019-07-24,63.2975,317506,150576,116666,283596,868344,610,432,30,28,1100
1652,2019-07-25,63.2375,310125,128412,105724,287437,831698,521,339,28,28,916
1653,2019-07-26,63.3675,333578,136192,115095,312481,897346,574,397,31,30,1032
1654,2019-07-29,63.4325,346192,158154,126784,314822,945952,609,420,33,31,1093
1655,2019-07-30,63.5075,360062,165778,131094,325378,982312,639,434,34,33,1140
1656,2019-07-31,63.625,387401,173992,137817,351226,1050436,663,448,35,33,1179
1657,2019-08-01,64.355,374691,148630,117481,343542,984344,612,354,33,31,1030
1658,2019-08-02,65.2725,415301,171405,142478,386374,1115558,762,384,35,33,1214
1659,2019-08-05,65.53,420236,175653,146518,391101,1133508,792,403,35,35,1265
1660,2019-08-06,65.2725,434071,182457,146479,398093,1161100,822,421,35,35,1313
1661,2019-08-07,65.3325,459088,199310,153373,413151,1224922,836,442,36,37,1351
1662,2019-08-08,65.045,441741,180371,158362,419732,1200206,732,372,32,36,1172
1663,2019-08-09,65.2825,446153,181427,157900,422626,1208106,783,415,33,35,1266
1664,2019-08-12,65.405,456844,187698,161074,430220,1235836,825,420,34,35,1314
1665,2019-08-13,64.93,467648,196582,165233,436299,1265762,804,436,33,35,1308
1666,2019-08-14,66.015,478464,203827,168918,443555,1294764,840,434,34,36,1344
1667,2019-08-15,66.0575,382755,144869,96343,334229,958196,662,323,24,25,1034
1668,2019-08-16,66.52,394044,153432,100553,341165,989194,740,392,27,28,1187
1669,2019-08-19,66.89,410259,161774,102570,351055,1025658,817,415,27,29,1288
1670,2019-08-20,66.565,417921,169136,109212,357997,1054266,865,442,29,28,1364
1671,2019-08-21,65.75,420526,175941,123054,367639,1087160,802,476,30,28,1336
1672,2019-08-22,65.6,403743,159268,124044,368519,1055574,675,386,27,26,1114
1673,2019-08-23,65.985,408309,163440,138890,383759,1094398,714,447,28,26,1215
1674,2019-08-26,66.07,410827,166928,140926,384825,1103506,738,472,28,26,1264
1675,2019-08-27,66.4425,430632,172221,141172,399583,1143608,790,482,28,27,1327
1676,2019-08-28,66.8,441399,179050,148960,411309,1180718,862,479,31,28,1400
1677,2019-08-29,66.59,439208,179833,158104,417479,1194624,780,367,30,27,1204
1678,2019-08-30,66.79,448084,186752,161986,423318,1220140,829,432,30,28,1319
1679,2019-09-02,66.79,459641,192641,163334,430334,1245950,847,461,32,29,1369
1680,2019-09-03,66.7575,480433,198972,164484,445945,1289834,871,472,34,29,1406
1681,2019-09-04,66.2225,486269,212133,173638,447774,1319814,854,499,33,30,1416
1682,2019-09-05,66.215,482415,207050,171640,447005,1308110,786,417,33,27,1263
1683,2019-09-06,65.73,481345,204843,181112,457614,1324914,785,472,31,29,1317
1684,2019-09-09,65.55,479448,206236,195606,468818,1350108,788,488,30,33,1339
1685,2019-09-10,65.42,487641,205056,195778,478363,1366838,793,499,31,30,1353
1686,2019-09-11,65.5,490235,207913,209404,491726,1399278,802,507,32,32,1373
1687,2019-09-12,64.7,482715,203806,207116,486025,1379662,706,438,30,26,1200
1688,2019-09-13,64.3375,467913,211228,203088,459773,1342002,677,471,29,29,1206
1689,2019-09-16,64.045,490053,214340,205531,481244,1391168,689,502,29,29,1249
1690,2019-09-17,64.36,498587,222683,214140,490044,1425454,711,517,29,29,1286
1691,2019-09-18,64.15,513055,226723,214806,501138,1455722,724,530,30,29,1313
1692,2019-09-19,64.005,106531,55036,31945,83440,276952,381,321,21,21,744
1693,2019-09-20,64.01,115804,66941,34626,83489,300860,450,376,21,22,869
1694,2019-09-23,63.835,118983,81002,48964,86945,335894,470,423,24,25,942
1695,2019-09-24,63.985,137955,89732,49424,97647,374758,500,452,24,24,1000
1696,2019-09-25,64.145,153765,94576,52341,111530,412212,555,464,25,24,1068
1697,2019-09-26,64.21,145034,80386,43650,108298,377368,482,356,22,21,881
1698,2019-09-27,64.6975,151244,86247,44071,109068,390630,515,407,23,22,967
1699,2019-09-30,64.865,157035,90625,43627,110037,401324,569,412,23,20,1024
1700,2019-10-01,65.265,165078,96521,43603,112160,417362,638,411,26,21,1096
1701,2019-10-02,65.195,175402,108995,46659,113066,444122,660,440,27,23,1150
1702,2019-10-03,65.1275,176549,115577,60327,121299,473752,616,374,25,20,1035
1703,2019-10-04,64.615,191624,125034,64967,131557,513182,613,442,26,24,1105
1704,2019-10-07,64.975,210699,134135,73175,149739,567748,673,460,25,25,1183
1705,2019-10-08,65.2,215639,135064,76271,156846,583820,692,468,24,25,1209
1706,2019-10-09,64.8875,216599,139054,78881,156426,590960,687,489,24,26,1226
1707,2019-10-10,64.4575,208692,130369,76699,155022,570782,600,415,24,23,1062
1708,2019-10-11,64.205,224004,146399,77481,155086,602970,599,459,22,24,1104
1709,2019-10-14,64.295,228996,150369,77616,156243,613224,628,478,22,25,1153
1710,2019-10-15,64.275,230951,156716,84152,158387,630206,643,487,23,25,1178
1711,2019-10-16,64.075,233711,161593,87817,159935,643056,652,500,23,27,1202
1712,2019-10-17,64.115,136455,80676,17993,73772,308896,446,338,21,20,825
1713,2019-10-18,63.76,165619,106042,36617,96194,404472,511,413,23,23,970
1714,2019-10-21,63.73,178033,119221,56785,115597,469636,554,468,25,24,1071
1715,2019-10-22,63.735,181738,123184,57691,116245,478858,565,488,27,24,1104
1716,2019-10-23,63.95,182823,125420,58935,116338,483516,592,491,27,26,1136
1717,2019-10-24,64.07,176500,122315,57037,111222,467074,524,387,25,23,959
1718,2019-10-25,63.8525,184118,140612,70527,114033,509290,554,465,27,25,1071
1719,2019-10-28,63.75,197254,140653,59592,116193,513692,579,491,26,25,1121
1720,2019-10-29,63.95,202872,146588,62585,118869,530914,622,509,27,26,1184
1721,2019-10-30,63.835,206444,149066,62162,119540,537212,635,512,28,28,1203
1722,2019-10-31,64.13,202152,144157,61976,119971,528256,593,411,27,23,1054
1723,2019-11-01,63.54,216945,155857,62963,124051,559816,605,504,29,26,1164
1724,2019-11-05,63.4925,236138,164895,64400,135643,601076,679,534,31,27,1271
1725,2019-11-06,63.8725,249863,169994,63921,143790,627568,706,537,31,27,1301
1726,2019-11-07,63.52,241799,161956,62537,142380,608672,628,429,29,22,1108
1727,2019-11-08,63.8,249649,166364,65354,148639,630006,680,463,34,26,1203
1728,2019-11-11,63.89,251764,168428,66277,149613,636082,704,482,34,26,1246
1729,2019-11-12,64.23,269748,174709,65493,160532,670482,705,492,34,26,1257
1730,2019-11-13,64.35,297384,179418,74002,191968,742772,747,496,34,29,1306
1731,2019-11-14,63.98,303792,175149,82731,211374,773046,658,447,30,24,1159
1732,2019-11-15,63.7675,310847,180843,83387,213391,788468,679,497,33,28,1237
1733,2019-11-18,63.8225,313981,196265,117045,234761,862052,682,515,33,29,1259
1734,2019-11-19,63.82,308965,191170,117669,235464,853268,690,519,33,29,1271
1735,2019-11-20,63.89,319125,199006,137830,257949,913910,696,531,35,29,1291
1736,2019-11-21,63.72,226673,115399,107493,218767,668332,510,404,29,24,967
1737,2019-11-22,63.87,234144,122855,107765,219054,683818,580,474,29,24,1107
1738,2019-11-25,63.94,238631,126753,108154,220032,693570,628,503,29,24,1184
1739,2019-11-26,63.95,243785,130112,108087,221760,703744,651,515,30,24,1220
1740,2019-11-27,63.96,248260,132867,108373,223766,713266,660,526,29,26,1241
1741,2019-11-28,64.07,243763,126629,107353,224487,702232,591,436,26,24,1077
1742,2019-11-29,64.3175,249758,130266,107548,227040,714612,640,491,26,24,1181
1743,2019-12-02,64.175,272194,137959,107695,241930,759778,663,495,27,23,1208
1744,2019-12-03,64.145,273101,140832,109892,242161,765986,669,512,28,24,1233
1745,2019-12-04,63.95,278520,145146,114471,247845,785982,660,525,27,25,1237
1746,2019-12-05,63.7225,274049,141463,122541,255127,793180,609,453,28,25,1115
1747,2019-12-06,63.755,278967,146487,123801,256281,805536,631,498,28,26,1183
1748,2019-12-09,63.59,290522,148561,125056,267017,831156,657,511,30,27,1225
1749,2019-12-10,63.4925,304823,152722,130513,282614,870672,661,531,31,28,1251
1750,2019-12-11,63.27,310582,157130,130255,283707,881674,672,539,31,29,1271
1751,2019-12-12,62.8425,306543,152446,134654,288751,882394,610,457,29,27,1123
1752,2019-12-13,62.8975,326703,160925,153205,318983,959816,645,480,31,28,1184
1753,2019-12-16,62.445,357388,184575,201978,374791,1118732,640,500,30,30,1200
1754,2019-12-17,62.415,366928,199875,226849,393902,1187554,654,508,30,30,1222
1755,2019-12-18,62.665,369942,204571,232813,398184,1205510,661,524,32,34,1251
1756,2019-12-19,62.405,182932,108466,108151,182617,582166,370,309,24,21,724
1757,2019-12-20,62.2525,214088,123986,122994,213096,674164,432,380,27,25,864
1758,2019-12-23,62.265,221285,137364,137909,221830,718388,461,418,27,26,932
1759,2019-12-24,61.9675,229007,144482,143203,227728,744420,488,442,27,26,983
1760,2019-12-25,61.85,238499,159148,151016,230367,779030,514,458,27,27,1026
1761,2019-12-26,62.215,234006,129576,126460,230890,720932,462,333,26,22,843
1762,2019-12-27,62.0325,252067,135447,165006,281626,834146,504,392,28,23,947
1763,2019-12-30,61.985,296891,142252,167089,321728,927960,514,411,28,26,979
1764,2020-01-03,62.1,301016,144047,166056,323025,934144,551,417,27,26,1021
1765,2020-01-06,61.82,305958,147105,165759,324612,943434,567,438,27,26,1058
1766,2020-01-08,61.2475,314330,152552,167849,329627,964358,577,439,28,27,1071
1767,2020-01-09,61.2925,315790,149348,176330,342772,984240,557,393,27,27,1004
1768,2020-01-10,61.06,339978,167844,178072,350206,1036100,570,437,27,27,1061
1769,2020-01-13,61.2725,346450,173495,179740,352695,1052380,618,468,25,27,1138
1770,2020-01-14,61.445,344639,173553,183036,354122,1055350,625,475,25,28,1153
1771,2020-01-15,61.4175,344333,177164,191802,358971,1072270,622,479,28,30,1159
1772,2020-01-16,61.6625,216900,120331,99282,195851,632364,455,306,26,19,806
1773,2020-01-17,61.555,242733,155832,167649,254550,820764,486,388,26,20,920
1774,2020-01-20,61.5475,248014,159345,167881,256550,831790,536,405,26,20,987
1775,2020-01-21,61.8825,252567,162144,168386,258809,841906,564,406,26,21,1017
1776,2020-01-22,61.8425,257448,171418,191269,277299,897434,583,409,26,22,1040
1777,2020-01-23,61.905,248528,163356,191653,276825,880362,504,349,25,21,899
1778,2020-01-24,62.07,253987,168387,191786,277386,891546,557,409,26,21,1013
1779,2020-01-27,62.97,261867,174326,212440,299981,948614,637,412,27,23,1099
1780,2020-01-28,62.2925,265919,181115,224245,309049,980328,660,440,28,24,1152
1781,2020-01-29,62.54,273803,189035,225722,310490,999050,712,449,29,23,1213
1782,2020-01-30,63.26,269143,183272,226677,312548,991640,630,359,29,22,1040
1783,2020-01-31,63.915,287676,201311,227727,314092,1030806,747,401,31,24,1203
1784,2020-02-03,63.725,298410,213424,231412,316398,1059644,791,448,31,24,1294
1785,2020-02-04,63.105,301805,218261,231884,315428,1067378,801,479,32,26,1338
1786,2020-02-05,62.87,313444,220136,220286,313594,1067460,767,500,32,27,1326
1787,2020-02-06,63.355,312038,209739,220871,323170,1065818,737,400,31,25,1193
1788,2020-02-07,64.125,334390,233171,227050,328269,1122880,836,426,31,28,1321
1789,2020-02-10,64.13,350942,245570,236197,341569,1174278,877,452,32,29,1390
1790,2020-02-11,63.3725,355962,243534,236187,348615,1184298,852,479,34,30,1395
1791,2020-02-12,63.2125,351967,237227,237563,352303,1179060,834,496,34,30,1394
1792,2020-02-13,63.6325,351411,230433,235865,356843,1174552,810,404,33,29,1276
1793,2020-02-14,63.5625,364386,239003,236290,361673,1201352,846,448,33,29,1356
1794,2020-02-17,63.4675,376483,245200,239731,371014,1232428,858,469,32,32,1391
1795,2020-02-18,63.81,404242,252392,237367,389217,1283218,895,472,33,32,1432
1796,2020-02-19,63.575,412404,251985,236203,396622,1297214,906,488,34,32,1460
1797,2020-02-20,64.2,286491,188309,205402,303584,983786,662,336,29,25,1052
1798,2020-02-21,64.0725,320672,208841,214272,326103,1069888,785,414,29,28,1256
1799,2020-02-25,65.385,337474,222770,221306,336010,1117560,881,441,31,30,1383
1800,2020-02-26,65.47,348822,232358,223318,339782,1144280,930,460,32,30,1452
1801,2020-02-27,66.015,339238,221103,223730,341865,1125936,873,354,32,27,1286
1802,2020-02-28,66.8775,361401,241710,241245,360936,1205292,983,421,32,30,1466
1803,2020-03-02,66.4425,376446,257097,249193,368542,1251278,1044,473,32,31,1580
1804,2020-03-03,66.04,390570,268821,248135,369884,1277410,1015,518,31,32,1596
1805,2020-03-04,66.26,401511,276805,252567,377273,1308156,1058,518,30,32,1638
1806,2020-03-05,67.62,379363,254966,248887,373284,1256500,991,379,30,28,1428
1807,2020-03-06,68.5725,394771,268763,253277,379285,1296096,1142,430,31,28,1631
1808,2020-03-10,71.4,396021,277069,269385,388337,1330812,1115,471,32,27,1645
1809,2020-03-11,72.95,406819,285910,271444,392353,1356526,1177,491,32,27,1727
1810,2020-03-12,74.85,399562,278301,277217,398478,1353558,1163,408,32,27,1630
1811,2020-03-13,72.5975,405289,285025,280796,401060,1372170,1175,453,32,29,1689
1812,2020-03-16,74.6525,409013,291671,284173,401515,1386372,1231,495,32,28,1786
1813,2020-03-17,75.4425,414409,297343,284972,402038,1398762,1258,499,33,28,1818
1814,2020-03-18,80.87,433264,312121,286222,407365,1438972,1334,498,33,29,1894
1815,2020-03-19,79.125,98207,51444,16575,63338,229564,726,233,18,15,992
1816,2020-03-20,79.9325,109001,59828,19017,68190,256036,876,290,19,20,1205
1817,2020-03-23,79.6,118867,66544,25496,77819,288726,940,331,21,21,1313
1818,2020-03-24,78.28,124075,70489,26494,80080,301138,968,356,21,21,1366
1819,2020-03-25,78.25,129743,74244,30162,85661,319810,979,372,21,21,1393
1820,2020-03-26,77.4675,127886,72732,37011,92165,329794,887,246,22,20,1175
1821,2020-03-27,78.82,133123,79362,42107,95868,350460,945,333,23,21,1322
1822,2020-03-30,79.32,139016,84604,42305,96717,362642,1021,377,24,22,1444
1823,2020-03-31,78.3725,142917,87693,41865,97089,369564,1013,394,24,22,1453
1824,2020-04-01,78.79,147708,90995,40997,97710,377410,1034,416,24,22,1496
1825,2020-04-02,77.25,139833,84511,40146,95468,359958,938,309,24,20,1291
1826,2020-04-03,76.4925,145828,89723,38357,94462,368370,1018,396,24,22,1460
1827,2020-04-06,76.02,152510,96842,39316,94984,383652,1049,424,24,22,1519
1828,2020-04-07,75.54,153675,97564,39272,95383,385894,1024,445,24,22,1515
1829,2020-04-08,74.9725,154916,99588,40094,95422,390020,1029,465,23,23,1540
1830,2020-04-09,74.3,143875,88495,39792,95172,367334,953,370,21,21,1365
1831,2020-04-10,73.75,146925,94815,40737,92847,375324,999,454,20,21,1494
1832,2020-04-13,73.61,151634,98815,40878,93697,385024,1021,480,20,21,1542
1833,2020-04-14,73.0025,161690,109228,51302,103764,425984,998,502,21,22,1543
1834,2020-04-15,74.8125,166373,111931,50192,104634,433130,1015,497,22,21,1555
1835,2020-04-16,74.15,84032,74358,29604,39278,227272,694,310,19,21,1044
1836,2020-04-17,73.99,92112,83420,32894,41586,250012,764,421,21,21,1227
1837,2020-04-20,75.55,111698,96984,44034,58748,311464,803,452,21,21,1297
1838,2020-04-21,77.08,122553,106924,46276,61905,337658,885,449,21,22,1377
1839,2020-04-22,75.9025,130439,113211,46494,63722,353866,920,481,24,24,1449
1840,2020-04-23,74.77,112619,98041,45570,60148,316378,788,338,22,21,1169
1841,2020-04-24,74.545,123258,111681,55781,67358,358078,829,437,23,22,1311
1842,2020-04-27,74.495,126404,114895,56961,68470,366730,876,459,23,22,1380
1843,2020-04-28,74.1425,126569,115393,56520,67696,366178,917,497,23,22,1459
1844,2020-04-29,73.01,139841,128988,92245,103098,464172,918,524,23,21,1486
1845,2020-04-30,74.395,135873,129697,113838,120014,499422,852,396,22,21,1291
1846,2020-05-04,74.845,173790,162494,126179,137475,599938,986,484,24,22,1516
1847,2020-05-05,73.75,156772,172967,149467,133272,612478,997,506,24,22,1549
1848,2020-05-06,74.58,162597,178757,149688,133528,624570,1027,516,24,23,1590
1849,2020-05-07,74.1,154993,169040,143476,129429,596938,934,411,22,22,1389
1850,2020-05-08,73.4,164638,180202,146428,130864,622132,968,500,23,22,1513
1851,2020-05-12,73.71,168369,184273,147213,131309,631164,1018,531,23,22,1594
1852,2020-05-13,73.94,171522,189310,150255,132467,643554,1036,538,23,23,1620
1853,2020-05-14,73.48,168424,182056,145340,131708,627528,978,427,22,22,1449
1854,2020-05-15,73.58,173365,195085,153292,131572,653314,1036,520,24,22,1602
1855,2020-05-18,72.6775,173747,197291,154752,131208,656998,1027,563,23,21,1634
1856,2020-05-19,72.465,179113,195381,150467,134199,659160,1022,582,23,21,1648
1857,2020-05-20,71.09,199977,198869,165842,166950,731638,981,598,24,21,1624
1858,2020-05-21,70.9675,157690,157756,153823,153757,623026,797,403,20,21,1241
1859,2020-05-22,71.64,160644,138104,154367,176907,630022,868,479,20,20,1387
1860,2020-05-25,71.65,164665,142016,154791,177440,638912,927,518,19,20,1484
1861,2020-05-26,70.78,166579,146106,156637,177110,646432,909,555,20,20,1504
1862,2020-05-27,71.01,173082,153687,157838,177233,661840,958,562,20,21,1561
1863,2020-05-28,70.485,165356,142552,154626,177430,639964,886,451,19,21,1377
1864,2020-05-29,70.1425,170503,146475,162241,186269,665488,929,505,20,23,1477
1865,2020-06-01,69.12,174832,153610,164410,185632,678484,918,542,21,23,1504
1866,2020-06-02,68.73,188469,161619,162292,189142,701522,915,558,22,24,1519
1867,2020-06-03,68.665,193706,164905,162458,191259,712328,914,569,24,25,1532
1868,2020-06-04,69.1525,183451,160566,162266,185151,691434,864,471,22,24,1381
1869,2020-06-05,68.7,190682,166736,164315,188261,709994,888,530,24,24,1466
1870,2020-06-08,68.2,196216,173037,167132,190311,726696,941,543,25,24,1533
1871,2020-06-09,68.585,202022,177201,168089,192910,740222,969,562,26,25,1582
1872,2020-06-10,68.5,203131,178125,168601,193607,743464,974,581,27,25,1607
1873,2020-06-11,70.2,193032,167586,166567,192013,719198,898,510,24,24,1456
1874,2020-06-15,69.5775,202200,175119,165728,192809,735856,958,567,23,26,1574
1875,2020-06-16,69.6175,215427,185528,165006,194905,760866,960,584,23,27,1594
1876,2020-06-17,69.74,220162,188663,165585,197084,771494,977,595,25,27,1624
1877,2020-06-18,69.8625,44626,48331,16585,12880,122422,510,326,17,18,871
1878,2020-06-19,69.4375,54482,56626,17603,15459,144170,597,408,19,21,1045
1879,2020-06-22,69.02,61361,62715,18012,16658,158746,641,452,20,23,1136
1880,2020-06-23,68.8625,67388,66276,18228,19340,171232,658,493,20,25,1196
1881,2020-06-25,69.02,60809,57029,13742,17522,149102,593,341,17,21,972
1882,2020-06-26,69.8,66493,63453,15259,18299,163504,662,403,22,24,1111
1883,2020-06-29,69.99,76357,72251,15140,19246,182994,744,438,22,24,1228
1884,2020-06-30,71.2775,95871,93293,24391,26969,240524,828,465,23,24,1340
1885,2020-07-02,70.5525,84842,80804,16510,20548,202704,677,394,22,21,1114
1886,2020-07-03,71.37,99003,89537,17431,26897,232868,788,454,24,23,1289
1887,2020-07-06,71.8275,114136,101095,18207,31248,264686,857,501,26,24,1408
1888,2020-07-07,71.4725,121002,112160,22246,31088,286496,871,530,27,25,1453
1889,2020-07-08,71.11,122427,114397,26028,34058,296910,899,551,28,26,1504
1890,2020-07-09,70.915,107555,98624,26266,35197,267642,772,445,24,25,1266
1891,2020-07-10,70.7275,113314,105467,31689,39536,290006,798,525,24,29,1376
1892,2020-07-13,70.97,116015,107995,32114,40134,296258,819,559,25,31,1434
1893,2020-07-14,70.865,119732,110708,33210,42234,305884,822,572,27,31,1452
1894,2020-07-15,70.99,127850,117917,35091,45024,325882,848,583,27,32,1490
1895,2020-07-16,71.53,67730,60569,15748,22909,166956,595,370,21,22,1008
1896,2020-07-17,71.8725,79603,72266,16903,24240,193012,703,473,26,31,1233
1897,2020-07-20,71.3325,84269,77986,18386,24669,205310,715,517,28,32,1292
1898,2020-07-21,70.705,86677,82135,20351,24893,214056,693,564,29,34,1320
1899,2020-07-22,71.0575,93241,87178,20545,26608,227572,719,580,28,33,1360
1900,2020-07-23,71.47,79929,75971,16624,20582,193106,647,425,20,22,1114
1901,2020-07-24,71.735,91140,87440,16326,20026,214932,742,520,21,23,1306
1902,2020-07-27,71.5725,94690,90201,16691,21180,222762,778,540,22,25,1365
1903,2020-07-28,72.59,111111,99213,16339,28237,254900,861,551,22,27,1461
1904,2020-07-29,72.57,118119,102392,15997,31724,268232,883,574,22,28,1507
1905,2020-07-30,73.17,105132,93842,21308,32598,252880,816,432,24,21,1293
1906,2020-07-31,74.42,120975,107172,21041,34844,284032,921,526,24,24,1495
1907,2020-08-03,73.1125,131767,118836,22693,35624,308920,959,554,24,25,1562
1908,2020-08-04,73.56,142517,125703,23805,40619,332644,965,583,25,28,1601
1909,2020-08-05,72.88,145253,132827,28930,41356,348366,946,601,24,28,1599
1910,2020-08-06,73.2825,131663,113431,19106,37338,301538,859,446,21,24,1350
1911,2020-08-07,73.7275,141991,123276,19734,38449,323450,919,542,23,27,1511
1912,2020-08-10,73.4725,146397,127630,19978,38745,332750,956,565,24,27,1572
1913,2020-08-11,73.11,151627,134802,21545,38370,346344,930,613,24,27,1594
1914,2020-08-12,73.7125,157696,138230,20943,40409,357278,974,618,24,27,1643
1915,2020-08-13,72.9425,142973,126127,20897,37743,327740,858,508,21,26,1413
1916,2020-08-14,72.875,150138,134239,21605,37504,343486,901,586,21,26,1534
1917,2020-08-17,73.735,153744,137382,21225,37587,349938,947,593,22,27,1589
1918,2020-08-18,73.16,159084,142442,21935,38577,362038,935,624,23,29,1611
1919,2020-08-19,73.3025,162301,146567,23928,39662,372458,949,640,25,28,1642
1920,2020-08-20,73.79,116510,102839,17482,31153,267984,756,417,22,25,1220
1921,2020-08-21,74.8,128813,115276,23346,36883,304318,882,498,24,26,1430
1922,2020-08-24,74.6675,135238,119684,24513,40067,319502,910,532,24,26,1492
1923,2020-08-25,75.3275,144602,126184,25256,43674,339716,965,545,24,29,1563
1924,2020-08-26,75.3775,158886,137831,29500,50555,376772,1026,577,27,31,1661
1925,2020-08-27,74.965,144354,119736,18526,43144,325760,855,464,23,28,1370
1926,2020-08-28,74.0125,151385,129514,21881,43752,346532,859,589,24,28,1500
1927,2020-08-31,74.075,155485,134861,23440,44064,357850,901,643,25,29,1598
1928,2020-09-01,73.5775,160966,141018,24454,44402,370840,883,666,25,28,1602
1929,2020-09-02,75.41,170044,149439,28602,49207,397292,984,660,25,28,1697
1930,2020-09-03,75.28,159897,134378,24891,50410,369576,917,519,25,25,1486
1931,2020-09-04,75.4325,168750,147774,28850,49826,395200,980,625,26,28,1659
1932,2020-09-07,75.77,179522,159679,34351,54194,427746,1017,644,30,29,1720
1933,2020-09-08,76.28,196265,166236,41712,71741,475954,1094,644,29,30,1797
1934,2020-09-09,75.325,199358,172674,45421,72105,489558,1051,667,30,30,1778
1935,2020-09-10,75.2525,184337,166984,50455,67808,469584,921,576,28,28,1553
1936,2020-09-11,75.05,193994,177093,51861,68762,491710,965,669,29,31,1694
1937,2020-09-14,75.2725,202396,185208,52149,69337,509090,987,675,30,32,1724
1938,2020-09-15,74.99,215862,189881,53937,79918,539598,988,693,30,32,1743
1939,2020-09-16,74.97,219726,193331,53579,79974,546610,992,707,30,32,1761
1940,2020-09-17,75.17,70067,52004,18619,36682,177372,514,378,17,24,933
1941,2020-09-18,75.745,79982,59737,19330,39575,198624,611,461,20,25,1117
1942,2020-09-21,76.13,95415,70552,19264,44127,229358,782,490,22,28,1322
1943,2020-09-22,76.1075,103393,76705,19439,46127,245664,799,513,22,28,1362
1944,2020-09-23,77.0825,119721,90560,19464,48625,278370,904,518,21,29,1472
1945,2020-09-24,77.14,101171,76641,21589,46119,245520,817,436,19,26,1298
1946,2020-09-25,78.2075,128858,100481,61158,89535,380032,1018,504,25,28,1575
1947,2020-09-28,79.08,156908,126437,64228,94699,442272,1186,562,24,30,1802
1948,2020-09-29,79.0775,181627,147144,64520,99003,492294,1311,614,24,31,1980
1949,2020-09-30,77.63,185738,150118,67054,102674,505584,1276,644,26,34,1980
1950,2020-10-01,77.365,163602,125154,62196,100644,451596,1045,539,24,32,1640
1951,2020-10-02,78.2025,186683,147472,64755,103966,502876,1196,611,26,36,1869
1952,2020-10-05,78.105,212513,169692,65744,108565,556514,1276,636,27,36,1975
1953,2020-10-06,78.465,222421,178478,66191,110134,577224,1255,679,27,36,1997
1954,2020-10-07,78.0225,222349,182492,68333,108190,581364,1279,694,28,36,2037
1955,2020-10-08,77.3575,186431,155524,38329,69236,449520,1063,583,22,33,1701
1956,2020-10-09,76.7675,197757,170036,45429,73150,486372,1060,707,22,35,1824
1957,2020-10-12,77.105,198978,172825,45302,71455,488560,1103,704,22,33,1862
1958,2020-10-13,77.05,203677,176228,44951,72400,497256,1137,703,22,34,1896
1959,2020-10-14,77.64,217782,188881,48282,77183,532128,1173,700,24,34,1931
1960,2020-10-15,78.075,132291,109462,26125,48954,316832,844,472,19,30,1365
1961,2020-10-16,77.9375,147010,125720,29267,50557,352554,956,618,22,31,1627
1962,2020-10-19,77.665,152450,132226,30144,50368,365188,991,664,24,32,1711
1963,2020-10-20,77.34,158125,136628,30234,51731,376718,982,690,24,32,1728
1964,2020-10-21,76.725,163468,144183,32959,52244,392854,954,737,24,32,1747
1965,2020-10-22,76.5825,148206,127617,30406,50995,357224,820,585,22,29,1456
1966,2020-10-23,76.125,160713,140803,32306,52216,386038,881,699,23,34,1637
1967,2020-10-26,76.38,167075,147547,33577,53105,401304,918,724,23,34,1699
1968,2020-10-27,77.31,173034,156188,37502,54348,421072,963,733,24,34,1754
1969,2020-10-28,79.23,211198,183001,41594,69791,505584,1114,728,24,37,1903
1970,2020-10-29,78.875,190027,162284,40782,68525,461618,999,620,26,34,1679
1971,2020-10-30,79.53,200231,171425,44013,72819,488488,1109,718,28,36,1891
1972,2020-11-02,80.55,224480,183987,46650,87143,542260,1218,728,27,36,2009
1973,2020-11-03,79.345,239109,187706,43673,95076,565564,1236,761,27,36,2060
1974,2020-11-05,77.0,221869,158880,42240,105229,528218,1017,633,24,34,1708
1975,2020-11-06,77.41,235848,171185,41486,106149,554668,1076,716,26,37,1855
1976,2020-11-09,76.28,244794,181589,79309,142514,648206,1048,782,26,38,1894
1977,2020-11-10,76.55,260284,194392,79626,145518,679820,1109,808,26,38,1981
1978,2020-11-11,77.1325,266424,199723,87430,154131,707708,1135,826,26,38,2025
1979,2020-11-12,77.37,241335,174303,85576,152608,653822,988,663,25,34,1710
1980,2020-11-13,77.3875,246337,181150,85535,150722,663744,1057,734,26,33,1850
1981,2020-11-16,76.16,253348,188519,86504,151333,679704,1088,767,28,35,1918
1982,2020-11-17,76.22,259830,192703,86183,153310,692026,1112,803,28,36,1979
1983,2020-11-18,76.06,261736,194315,85129,152550,693730,1142,848,27,36,2053
1984,2020-11-19,76.05,178945,132247,70477,117175,498844,900,590,24,34,1548
1985,2020-11-20,76.2,187356,146612,76808,117552,528328,985,707,25,36,1753
1986,2020-11-23,76.175,196015,154539,77602,119078,547234,1048,745,25,36,1854
1987,2020-11-24,75.48,198917,158143,77686,118460,553206,1079,775,24,36,1914
1988,2020-11-25,75.5625,204952,166153,79530,118329,568964,1094,800,25,35,1954
1989,2020-11-26,75.715,190219,147172,73495,116542,527428,987,665,25,29,1706
1990,2020-11-27,75.8525,197036,153475,73587,117148,541246,1071,738,25,32,1866
1991,2020-11-30,76.39,201981,157540,74523,118964,553008,1103,770,25,33,1931
1992,2020-12-01,75.8475,202685,159649,75861,118897,557092,1102,798,25,33,1958
1993,2020-12-02,75.07,204460,161821,75976,118615,560872,1101,814,27,33,1975
1994,2020-12-03,74.45,203980,158056,78563,124487,565086,964,674,23,33,1694
1995,2020-12-04,74.05,228000,179636,86742,135106,629484,1025,745,22,36,1828
1996,2020-12-07,73.64,230745,184866,89626,135505,640742,1006,752,22,35,1815
1997,2020-12-08,73.505,235645,190593,90444,135496,652178,1020,763,22,35,1840
1998,2020-12-09,73.86,241169,195356,91264,137077,664866,1061,777,24,36,1898
1999,2020-12-10,73.0475,223010,172261,86171,136920,618362,976,687,24,30,1717
2000,2020-12-10,73.0475,223010,172261,86171,136920,618362,976,687,24,30,1717
2001,2020-12-11,72.945,234245,183035,88413,139623,645316,1022,757,22,31,1832
2002,2020-12-14,73.87,235983,185477,88561,139067,649088,1050,773,22,33,1878
2003,2020-12-15,73.3925,239588,189380,89027,139235,657230,1062,764,22,34,1882
2004,2020-12-16,73.3475,241548,191874,89524,139198,662144,1075,768,22,35,1900
2005,2020-12-17,72.8325,97646,58799,18540,57387,232372,573,443,12,16,1044
2006,2020-12-18,73.3475,109389,71544,21113,58958,261004,676,520,13,19,1228
2007,2020-12-21,74.8,129958,92270,24652,62340,309220,792,555,15,18,1380
2008,2020-12-22,75.91,142015,105563,27164,63616,338358,860,582,14,19,1475
2009,2020-12-23,75.08,148298,117039,32000,63259,360596,870,619,14,20,1523
2010,2020-12-24,73.895,118232,83144,24967,60055,286398,682,488,13,19,1202
2011,2020-12-25,74.17,159382,95755,32275,95902,383314,753,586,14,21,1374
2012,2020-12-28,73.77,164788,100786,32667,96669,394910,801,623,14,24,1462
2013,2020-12-29,74.0375,164587,103062,34920,96445,399014,791,644,14,24,1473
2014,2020-12-30,74.415,151602,91212,34814,95204,372832,706,534,13,19,1272
2015,2021-01-04,74.33,158803,100418,37529,95914,392664,766,650,15,22,1453
2016,2021-01-05,74.04,173410,112131,41906,103185,430632,818,675,14,23,1530
2017,2021-01-06,73.9225,161129,98476,37190,99843,396638,730,575,15,20,1340
2018,2021-01-08,74.155,170006,105069,35158,100095,410328,810,648,14,21,1493
2019,2021-01-11,74.66,185379,113899,35257,106737,441272,936,668,15,22,1641
2020,2021-01-12,73.54,187488,121827,40991,106652,456958,890,735,16,23,1664
2021,2021-01-13,73.7475,196281,127728,100392,168945,593346,922,763,17,25,1727
2022,2021-01-14,73.21,184153,114975,98345,167523,564996,846,640,17,24,1527
2023,2021-01-15,73.645,197879,125793,97645,169731,591048,919,691,18,26,1654
2024,2021-01-18,73.995,207964,131420,94288,170832,604504,976,717,18,27,1738
2025,2021-01-19,73.68,211536,134238,95325,172623,613722,980,760,19,28,1787
2026,2021-01-20,73.52,224145,142962,96708,177891,641706,998,774,19,28,1819
2027,2021-01-21,73.845,123606,71060,77545,130091,402302,740,523,17,22,1302
2028,2021-01-22,75.3,142693,87699,71835,126829,429056,957,603,18,24,1602
2029,2021-01-25,75.3675,161329,101923,71704,131110,466066,1053,642,18,25,1738
2030,2021-01-26,75.085,171561,110892,72735,133404,488592,1089,669,18,25,1801
2031,2021-01-27,75.85,178732,118641,73506,133597,504476,1153,682,19,25,1879
2032,2021-01-28,75.9575,168698,102161,75152,141689,487700,999,544,16,20,1579
2033,2021-01-29,75.755,182225,115126,75696,142795,515842,1058,672,16,22,1768
2034,2021-02-01,76.1475,186869,119667,77020,144222,527778,1135,705,17,22,1879
2035,2021-02-02,76.225,196172,127690,77466,145948,547276,1173,749,17,22,1961
2036,2021-02-03,75.9275,201488,133475,77648,145661,558272,1200,773,17,23,2013
2037,2021-02-04,75.505,187775,123507,76451,140719,528452,1034,619,19,22,1694
2038,2021-02-05,74.645,198524,131803,77522,144243,552092,1023,776,21,25,1845
2039,2021-02-08,74.3,205970,139165,78380,145185,568700,1073,819,20,25,1937
2040,2021-02-09,73.8875,217393,148236,79608,148765,594002,1047,837,19,26,1929
2041,2021-02-10,73.945,222987,152716,80405,150676,606784,1059,872,19,28,1978
2042,2021-02-11,73.605,202779,135428,78950,146301,563458,962,684,15,25,1686
2043,2021-02-12,73.7175,208765,140347,79384,147802,576298,1037,755,16,27,1835
2044,2021-02-15,73.325,217340,148903,79976,148413,594632,1066,794,15,27,1902
2045,2021-02-16,73.64,220223,152512,81622,149333,603690,1097,810,16,28,1951
2046,2021-02-17,73.71,229166,158739,81802,152229,621936,1117,806,17,28,1968
2047,2021-02-18,73.91,172056,106702,72976,138330,490064,868,559,16,22,1465
2048,2021-02-19,74.125,184537,115945,73633,142225,516340,934,689,16,26,1665
2049,2021-02-20,74.08,188360,121268,75491,142583,527702,954,707,16,26,1703
2050,2021-02-22,74.3,197244,126651,76627,147220,547742,993,709,16,26,1744
2051,2021-02-24,73.54,211305,138421,76526,149410,575662,1002,761,15,28,1806
2052,2021-02-25,74.75,196304,122116,73919,148107,540446,928,619,15,25,1587
2053,2021-02-26,74.63,211720,136174,74469,150015,572378,1041,698,17,29,1785
2054,2021-03-01,74.165,216418,142821,77194,150791,587224,1051,750,17,29,1847
2055,2021-03-02,73.81,219629,149303,80227,150553,599712,1063,798,21,30,1912
2056,2021-03-03,73.97,227527,153618,80094,154003,615242,1116,817,20,30,1983
2057,2021-03-04,74.7,229023,138345,81351,172029,620748,954,683,18,28,1683
2058,2021-03-05,74.2025,243576,151952,82038,173662,651228,1060,740,18,29,1847
2059,2021-03-09,73.915,260843,168680,83115,175278,687916,1100,795,18,27,1940
2060,2021-03-10,73.6025,264943,174898,84693,174738,699272,1099,824,18,28,1969
2061,2021-03-11,73.3,246037,156143,83663,173557,659400,1004,709,18,26,1757
2062,2021-03-12,73.33,255366,168617,92084,178833,694900,1135,785,19,30,1969
2063,2021-03-15,72.805,269425,176511,87610,180524,714070,1169,808,20,30,2027
2064,2021-03-16,72.85,275151,181199,88713,182665,727728,1151,832,21,30,2034
2065,2021-03-17,73.64,299916,192803,87886,194999,775604,1184,797,21,32,2034
2066,2021-03-18,74.3025,126565,74070,6246,58741,265622,693,479,15,23,1210
2067,2021-03-19,74.115,139509,86242,6956,60223,292930,823,618,15,28,1484
2068,2021-03-22,74.94,151374,95386,31476,87464,365700,947,633,17,29,1626
2069,2021-03-23,76.39,194946,127474,35523,102995,460938,1132,650,24,33,1839
2070,2021-03-24,76.5775,218014,143677,37247,111584,510522,1228,687,26,34,1975
2071,2021-03-25,76.21,180091,106648,33808,107251,427798,1000,551,28,30,1609
2072,2021-03-26,75.655,197684,121563,35844,111965,467056,1106,684,29,32,1851
2073,2021-03-29,75.68,206254,131216,37513,112551,487534,1153,723,29,32,1937
2074,2021-03-30,75.85,209890,134501,40122,115511,500024,1173,739,28,31,1971
2075,2021-03-31,75.69,216202,143597,42913,115518,518230,1117,783,29,32,1961
2076,2021-04-01,76.2575,198503,117517,39588,120574,476182,1043,597,27,28,1695
2077,2021-04-02,76.5525,205929,125078,39551,120402,490960,1109,700,27,32,1868
2078,2021-04-05,76.39,213538,132308,42128,123358,511332,1139,753,27,32,1951
2079,2021-04-06,77.265,228273,139332,43898,132839,544342,1216,762,27,35,2040
2080,2021-04-07,76.98,252264,158838,50176,143602,604880,1297,780,28,36,2141
2081,2021-04-08,76.855,233866,142949,50468,141385,568668,1154,651,28,32,1865
2082,2021-04-09,77.395,252213,158337,50082,143958,604590,1271,733,29,38,2071
2083,2021-04-12,77.385,260128,169351,50445,141222,621146,1319,769,30,37,2155
2084,2021-04-13,75.94,258979,170379,51541,140141,621040,1231,802,28,40,2101
2085,2021-04-14,75.87,261993,177066,53878,138805,631742,1171,847,28,41,2087
2086,2021-04-15,76.325,177033,100544,39420,115909,432906,805,593,19,28,1445
2087,2021-04-16,75.8175,193622,117277,43113,119458,473470,880,728,18,34,1660
2088,2021-04-19,76.35,206775,121964,41945,126756,497440,994,746,18,34,1792
2089,2021-04-20,76.83,214859,129033,42239,128065,514196,1074,758,19,35,1886
2090,2021-04-21,76.6,220626,135787,42595,127434,526442,1102,780,18,34,1934
2091,2021-04-22,75.4175,193387,115050,43820,122157,474414,816,649,18,29,1512
2092,2021-04-23,74.98,208376,133483,49231,124124,515214,869,790,17,35,1711
2093,2021-04-26,74.97,212609,138665,50518,124462,526254,915,821,17,35,1788
2094,2021-04-27,74.89,215371,139483,50660,126548,532062,961,843,17,35,1856
2095,2021-04-28,74.4125,220135,142658,51909,129386,544088,985,868,18,35,1906
2096,2021-04-29,74.635,208623,131931,50068,126760,517382,834,718,17,29,1598
2097,2021-04-30,75.21,218366,141022,49572,126916,535876,911,818,17,36,1782
2098,2021-05-04,74.8425,221952,145055,49726,126623,543356,947,835,18,36,1836
2099,2021-05-05,74.86,224894,147209,49206,126891,548200,956,835,18,37,1846
2100,2021-05-06,74.23,213398,136801,49453,126050,525702,827,730,17,31,1605
2101,2021-05-07,73.785,223781,147442,51512,127851,550586,883,819,17,36,1755
2102,2021-05-10,74.35,228645,151051,51161,128755,559612,925,839,18,36,1818
2103,2021-05-11,74.11,231323,153069,50597,128851,563840,928,851,18,36,1833
2104,2021-05-12,74.63,235670,156085,49247,128832,569834,959,865,18,38,1880
2105,2021-05-13,74.0775,225114,144012,49367,130469,548962,833,746,19,32,1630
2106,2021-05-14,74.0125,231507,149944,49017,130580,561048,892,828,19,37,1776
2107,2021-05-17,73.8,235308,152581,48338,131065,567292,930,852,19,37,1838
2108,2021-05-18,73.7,238050,156789,51118,132379,578336,962,873,21,38,1894
2109,2021-05-19,73.79,240086,159888,52319,132517,584810,951,891,21,38,1901
2110,2021-05-20,73.53,186832,105421,42213,123624,458090,698,665,15,30,1408
2111,2021-05-21,73.5975,193894,113278,44154,124770,476096,799,767,16,34,1616
2112,2021-05-24,73.4925,198132,117031,45140,126241,486544,831,800,16,34,1681
2113,2021-05-25,73.5,209666,124167,45696,131195,510724,846,829,16,34,1725
2114,2021-05-26,73.51,216021,130014,45722,131729,523486,862,844,16,34,1756
2115,2021-05-27,73.465,206728,121405,45512,130835,504480,738,712,15,29,1494
2116,2021-05-28,73.15,212266,127782,46139,130623,516810,792,805,15,33,1645
2117,2021-05-31,73.43,222522,140040,49590,132072,544224,832,816,16,32,1696
2118,2021-06-01,73.5075,231231,149922,53158,134467,568778,863,826,16,32,1737
2119,2021-06-02,73.16,272871,153344,53894,173421,653530,860,842,16,31,1749
2120,2021-06-03,73.24,265744,145358,63837,184223,659162,761,721,16,27,1525
2121,2021-06-04,72.795,275165,154181,65416,186400,681162,818,813,16,30,1677
2122,2021-06-07,72.81,280563,159477,66596,187682,694318,875,829,16,31,1751
2123,2021-06-08,72.3,285555,161688,71069,194936,713248,880,857,17,33,1787
2124,2021-06-09,72.305,285919,171295,94053,208677,759944,914,865,19,33,1831
2125,2021-06-10,71.77,289341,162069,92484,219756,763650,846,755,20,29,1650
2126,2021-06-11,72.13,303441,175343,110998,239096,828878,932,800,21,35,1788
2127,2021-06-14,72.1025,302112,174737,111551,238926,827326,948,807,21,35,1811
2128,2021-06-15,72.18,310533,182777,118510,246266,858086,980,811,23,35,1849
2129,2021-06-16,72.5625,319158,190106,120554,249606,879424,1004,825,23,35,1887
2130,2021-06-17,72.3225,146584,65801,24796,105579,342760,532,508,14,21,1075
2131,2021-06-18,72.85,154806,72200,25289,107895,360190,622,609,15,22,1268
2132,2021-06-21,73.1325,163057,78433,25377,110001,376868,717,651,16,23,1407
2133,2021-06-22,72.875,172750,83088,25430,115092,396360,749,672,17,24,1462
2134,2021-06-23,72.6075,148042,98078,26972,76936,350028,746,706,17,23,1492
2135,2021-06-24,72.305,133072,81839,26138,77371,318420,612,593,14,20,1239
2136,2021-06-25,72.2025,142911,90832,27001,79080,339824,689,689,15,25,1418
2137,2021-06-28,72.1175,148181,98295,30015,79901,356392,728,703,17,26,1474
2138,2021-06-29,72.76,153297,101643,30572,82226,367738,792,701,16,26,1535
2139,2021-06-30,73.135,167359,111066,30436,86729,395590,823,698,16,24,1561
2140,2021-07-01,73.4,152251,98350,35657,89558,375816,712,600,16,19,1347
2141,2021-07-02,73.24,170353,116883,38711,92181,418128,815,682,16,20,1533
2142,2021-07-05,73.46,172796,120927,40457,92326,426506,867,705,17,20,1609
2143,2021-07-06,74.4225,184727,130658,43874,97943,457202,930,710,18,19,1677
2144,2021-07-07,74.7125,201230,141055,44034,104209,490528,977,692,18,23,1710
2145,2021-07-08,74.7375,204769,137383,47710,115096,504958,871,617,17,22,1527
2146,2021-07-09,74.36,230749,164566,55965,122148,573428,885,720,17,22,1644
2147,2021-07-12,74.44,242859,169357,52783,126285,591284,951,743,17,22,1733
2148,2021-07-13,74.295,244993,172710,53841,126124,597668,950,761,16,22,1749
2149,2021-07-14,74.075,248007,174941,54619,127685,605252,952,771,17,21,1761
2150,2021-07-15,74.365,168857,97644,38665,109878,415044,615,541,16,21,1193
2151,2021-07-16,74.0725,181196,109511,39718,111403,441828,715,649,17,21,1402
2152,2021-07-19,74.65,196775,124293,41345,113827,476240,783,665,17,20,1485
2153,2021-07-20,74.37,200600,128664,41989,113925,485178,815,690,18,21,1544
2154,2021-07-21,74.015,199924,130984,44463,113403,488774,791,711,18,21,1541
2155,2021-07-22,73.7,187921,116292,44979,116608,465800,678,579,16,21,1294
2156,2021-07-23,73.76,202224,131715,46145,116654,496738,752,678,18,23,1471
2157,2021-07-26,73.65,207820,139298,49154,117676,513948,781,699,18,23,1521
2158,2021-07-27,73.7325,213073,144344,50695,119424,527536,796,716,18,24,1554
2159,2021-07-28,73.4775,221108,151084,50496,120520,543208,827,743,16,24,1610
2160,2021-07-29,73.1525,199757,126433,49150,122474,497814,688,653,15,24,1380
2161,2021-07-30,73.16,213864,137266,50753,127351,529234,735,740,16,25,1516
2162,2021-08-02,73.0575,216539,141138,52342,127743,537762,775,775,15,27,1592
2163,2021-08-03,72.94,241440,146439,53365,148366,589610,811,780,15,27,1633
2164,2021-08-04,73.17,252501,151825,55537,156213,616076,814,796,15,30,1655
2165,2021-08-05,73.07,247258,147009,54839,155088,604194,736,688,15,26,1465
2166,2021-08-06,73.49,253703,153685,56279,156297,619964,803,756,17,30,1606
2167,2021-08-09,73.665,261901,158782,55857,158976,635516,834,779,17,30,1660
2168,2021-08-10,73.9175,268600,164474,56638,160764,650476,870,775,17,31,1693
2169,2021-08-11,73.365,275117,170860,57583,161840,665400,876,787,17,35,1715
2170,2021-08-12,73.5925,262488,159091,58167,161564,641310,769,675,17,30,1491
2171,2021-08-13,73.21,266005,168332,62814,160487,657638,792,752,17,33,1594
2172,2021-08-16,73.2375,268510,171805,63729,160434,664478,824,765,17,33,1639
2173,2021-08-17,73.57,287685,178524,63247,172408,701864,844,776,17,32,1669
2174,2021-08-18,73.82,306452,180499,63906,189859,740716,842,774,19,32,1667
2175,2021-08-19,74.2,254304,128161,36396,162539,581400,700,581,17,25,1323
2176,2021-08-20,74.26,266825,144041,39696,162480,613042,799,662,18,30,1509
2177,2021-08-23,74.1225,272651,151712,40978,161917,627258,815,705,18,30,1568
2178,2021-08-24,73.73,284945,164202,54947,175690,679784,798,757,19,31,1605
2179,2021-08-25,73.9325,291938,169977,55279,177240,694434,825,775,20,31,1651
2180,2021-08-26,74.23,277817,145382,43833,176268,643300,742,641,17,26,1426
2181,2021-08-27,73.53,292838,164861,46130,174107,677936,777,735,17,30,1559
2182,2021-08-30,73.5,302962,166641,50166,186487,706256,803,770,17,28,1618
2183,2021-08-31,73.2175,302297,169978,52495,184814,709584,794,788,17,28,1627
2184,2021-09-01,72.98,314158,172698,55909,197369,740134,789,809,18,28,1644
2185,2021-09-02,72.87,300489,155920,53012,197581,707002,735,678,17,25,1455
2186,2021-09-03,72.7225,312252,160111,53411,205552,731326,773,740,17,29,1559
2187,2021-09-06,72.99,322775,166521,52603,208857,750756,794,749,18,31,1592
2188,2021-09-07,73.2725,329540,172855,52617,209302,764314,821,756,18,31,1626
2189,2021-09-08,73.1475,336493,175175,52210,213528,777406,867,762,18,31,1678
2190,2021-09-09,72.975,332515,166325,50002,216192,765034,775,691,19,27,1512
2191,2021-09-10,73.175,345158,172034,50507,223631,791330,804,744,19,31,1598
2192,2021-09-13,72.655,366457,178145,50743,239055,834400,811,769,19,31,1630
2193,2021-09-14,72.9,373446,181758,49531,241219,845954,822,771,19,31,1643
2194,2021-09-15,72.275,391014,187364,51403,255053,884834,800,763,18,31,1612
2195,2021-09-16,72.5,138875,69806,14278,83347,306306,455,477,13,17,962
2196,2021-09-17,72.8525,157677,81682,18505,94500,352364,544,583,13,20,1160
2197,2021-09-20,73.425,170008,105436,31727,96299,403470,639,624,15,21,1299
2198,2021-09-21,73.085,175809,112316,32697,96190,417012,663,659,15,21,1358
2199,2021-09-22,72.9725,181179,119232,36226,98173,434810,666,709,15,23,1413
2200,2021-09-23,72.8425,162121,101218,34597,95500,393436,539,578,15,19,1151
2201,2021-09-24,72.7225,177129,113506,36880,100503,428018,611,663,15,21,1310
2202,2021-09-27,72.53,182961,117522,42689,108128,451300,652,707,15,24,1398
2203,2021-09-28,72.795,190222,121825,43849,112246,468142,701,711,15,26,1453
2204,2021-09-29,72.84,196204,127834,44288,112658,480984,730,736,15,26,1507
2205,2021-09-30,72.735,185138,114777,47296,117657,464868,616,627,16,22,1281
2206,2021-10-01,72.73,193813,128957,53555,118411,494736,693,689,16,28,1426
2207,2021-10-04,72.51,200300,135211,53553,118642,507706,709,722,16,28,1475
2208,2021-10-05,72.37,206962,141875,54121,119208,522166,745,744,16,28,1533
2209,2021-10-06,72.39,209258,145761,57319,120816,533154,769,745,17,28,1559
2210,2021-10-07,71.7,206170,141587,57388,121971,527116,675,637,16,22,1350
2211,2021-10-08,71.875,227100,157784,50315,119631,554830,748,709,17,27,1501
2212,2021-10-11,71.865,234575,161225,51161,124511,571472,805,715,16,27,1563
2213,2021-10-12,71.805,241717,164490,51075,128302,585584,814,733,17,28,1592
2214,2021-10-13,71.97,393766,166536,51943,279173,891418,837,734,17,31,1619
2215,2021-10-14,71.345,390370,158744,49964,281590,880668,717,650,17,27,1411
2216,2021-10-15,71.025,399956,169256,56669,287369,913250,742,717,17,32,1508
2217,2021-10-18,71.2875,406632,177343,54807,284096,922878,815,734,17,33,1599
2218,2021-10-19,70.8525,427448,186904,60029,300573,974954,793,754,17,33,1597
2219,2021-10-20,70.8025,433414,191565,60746,302595,988320,815,761,17,33,1626
2220,2021-10-21,71.095,361169,114498,40839,287510,804016,623,507,17,19,1166
2221,2021-10-22,70.3375,406729,142243,48924,313410,911306,694,663,18,28,1403
2222,2021-10-25,69.71,452379,167331,48985,334033,1002728,739,708,18,28,1493
2223,2021-10-26,69.5025,476192,184584,52702,344310,1057788,772,718,18,29,1537
2224,2021-10-27,70.6425,512684,203883,53857,362658,1133082,848,722,19,29,1618
2225,2021-10-28,70.2025,468129,153481,51210,365858,1038678,762,581,18,22,1383
2226,2021-10-29,70.955,481521,165451,51453,367523,1065948,834,663,18,28,1543
2227,2021-11-01,71.56,503868,185520,51020,369368,1109776,904,693,18,29,1644
2228,2021-11-02,71.5025,521129,200620,55104,375613,1152466,962,695,21,30,1708
2229,2021-11-03,71.73,507910,181875,59259,385294,1134338,825,612,20,24,1481
2230,2021-11-05,71.255,521288,199485,62751,384554,1168078,874,736,21,29,1660
2231,2021-11-08,71.2025,526097,209180,69497,386414,1191188,924,761,20,31,1736
2232,2021-11-09,70.755,529594,212871,72814,389537,1204816,913,791,20,32,1756
2233,2021-11-10,71.3,538632,210047,63796,392381,1204856,932,796,20,32,1780
2234,2021-11-11,71.63,513090,184797,62612,390905,1151404,862,635,20,25,1542
2235,2021-11-12,72.8875,552096,201974,68509,418631,1241210,992,678,21,28,1719
2236,2021-11-15,72.5,576475,219930,67609,424154,1288168,1039,720,22,28,1809
2237,2021-11-16,73.13,622222,243989,74614,452847,1393672,1091,726,22,29,1868
2238,2021-11-17,72.5,625984,249873,78679,454790,1409326,1072,762,22,30,1886
2239,2021-11-18,73.05,481988,153717,56228,384499,1076432,867,560,21,22,1470
2240,2021-11-19,73.445,506305,172357,56076,390024,1124762,960,696,22,27,1705
2241,2021-11-22,74.82,544686,185843,56002,414845,1201376,1155,694,22,28,1899
2242,2021-11-23,74.27,564013,193019,51941,422935,1231908,1272,708,23,30,2033
2243,2021-11-24,74.99,564336,194440,51775,421671,1232222,1310,728,24,31,2093
2244,2021-11-25,74.68,524487,159545,49539,414481,1148052,1089,553,22,25,1689
2245,2021-11-26,75.605,547040,173645,48683,422078,1191446,1192,639,22,29,1882
2246,2021-11-29,74.6,568733,194928,53127,426932,1243720,1154,700,22,29,1905
2247,2021-11-30,74.065,566985,196080,52711,423616,1239392,1167,737,23,30,1957
2248,2021-12-01,74.2775,575057,209456,54413,420014,1258940,1141,774,22,30,1967
2249,2021-12-02,73.64,557587,188453,52792,421926,1220758,1014,633,23,24,1694
2250,2021-12-03,73.8325,575802,201124,52254,426932,1256112,1080,717,24,30,1851
2251,2021-12-06,74.31,580083,204027,52043,428099,1264252,1126,749,24,31,1930
2252,2021-12-07,74.06,595209,216514,54700,433395,1299818,1188,778,24,31,2021
2253,2021-12-08,73.5875,591048,217026,56915,430937,1295926,1155,791,24,31,2001
2254,2021-12-09,73.685,567766,194055,53022,426733,1241576,1036,662,24,25,1747
2255,2021-12-10,73.3725,572162,202750,53923,423335,1252170,1075,751,23,30,1879
2256,2021-12-13,73.4975,575942,205844,54497,424595,1260878,1069,770,23,31,1893
2257,2021-12-14,73.8,590236,208495,54728,436469,1289928,1091,787,23,31,1932
2258,2021-12-15,73.71,678185,211584,54409,521010,1465188,1113,765,23,31,1932
2259,2021-12-16,73.7525,380052,67706,21118,333464,802340,560,389,16,21,986
2260,2021-12-17,74.13,396316,83552,24728,337492,842088,721,508,15,22,1266
2261,2021-12-20,74.145,418705,99328,27007,346384,891424,782,608,15,22,1427
2262,2021-12-21,73.9525,438584,114192,28392,352784,933952,797,650,15,22,1484
2263,2021-12-22,73.74,454222,121717,28535,361040,965514,808,692,15,21,1536
2264,2021-12-23,73.3,423625,89787,65135,398973,977520,640,524,16,19,1199
2265,2021-12-24,73.65,439854,103424,70494,406924,1020696,713,635,16,20,1384
2266,2021-12-27,73.4325,447191,113131,75908,409968,1046198,732,670,17,23,1442
2267,2021-12-28,73.7175,475876,117486,77567,435957,1106886,760,683,17,23,1483
2268,2021-12-29,73.9925,490815,131280,82153,441688,1145936,783,688,18,25,1514
2269,2021-12-30,74.68,479530,114874,79533,444189,1118126,729,533,19,25,1306
2270,2022-01-03,74.5425,490961,128148,81178,443991,1144278,800,649,20,25,1494
2271,2022-01-04,75.3625,497870,135723,82767,444914,1161274,911,648,20,24,1603
2272,2022-01-05,76.8,510605,147075,83798,447328,1188806,989,665,20,25,1699
2273,2022-01-06,76.3175,519004,158807,86934,447131,1211876,990,552,20,23,1585
2274,2022-01-07,75.75,528992,169238,87388,447142,1232760,979,678,21,24,1702
2275,2022-01-10,75.0,541347,181387,87903,447863,1258500,1040,762,20,25,1847
2276,2022-01-11,74.45,544701,187077,90192,447816,1269786,1041,828,20,26,1915
2277,2022-01-12,74.7075,547096,190907,113354,469543,1320900,1008,845,21,29,1903
2278,2022-01-13,76.2575,535051,172538,110471,472984,1291044,966,662,23,30,1681
2279,2022-01-14,76.21,578939,192381,113120,499678,1384118,1118,758,23,30,1929
2280,2022-01-17,76.0925,584795,199134,113187,498848,1395964,1161,769,23,31,1984
2281,2022-01-18,76.91,588250,203653,119404,504001,1415308,1210,761,24,30,2025
2282,2022-01-19,76.1775,605180,213144,119783,511819,1449926,1214,768,25,30,2037
2283,2022-01-20,76.6825,444808,101072,91534,435270,1072684,835,470,20,20,1345
2284,2022-01-21,77.425,463715,128419,105453,440749,1138336,959,629,22,26,1636
2285,2022-01-24,78.7625,508450,150994,111170,468626,1239240,1190,651,22,27,1890
2286,2022-01-25,78.6325,511577,156548,120664,475693,1264482,1294,673,25,27,2019
2287,2022-01-26,79.4175,522682,170374,124614,476922,1294592,1399,693,24,27,2143
2288,2022-01-27,77.96,476736,124074,92125,444787,1137722,1058,568,22,21,1669
2289,2022-01-28,77.8,499494,148918,97628,448204,1194244,1169,696,23,25,1913
2290,2022-01-31,77.315,504395,154028,98435,448802,1205660,1227,754,24,26,2031
2291,2022-02-01,76.805,503338,162289,108114,449163,1222904,1163,802,26,27,2018
2292,2022-02-02,76.04,508383,169532,110306,449157,1237378,1130,838,26,27,2021
2293,2022-02-03,76.4475,484449,142043,101795,444201,1172488,967,633,24,23,1647
2294,2022-02-04,75.83,496319,158114,107881,446086,1208400,1051,761,26,28,1866
2295,2022-02-07,75.475,501327,165154,110371,446544,1223396,1086,809,25,30,1950
2296,2022-02-08,75.0075,508587,172532,113489,449544,1244152,1090,850,25,31,1996
2297,2022-02-09,74.74,511902,176766,114749,449885,1253302,1075,870,26,32,2003
2298,2022-02-10,75.01,502401,162109,106806,447098,1218414,927,697,23,25,1672
2299,2022-02-11,77.1675,512517,173825,108448,447140,1241930,1045,791,24,30,1890
2300,2022-02-14,76.76,528095,186262,108712,450545,1273614,1173,816,25,30,2044
2301,2022-02-15,75.3125,527540,187155,82302,422687,1219684,1132,861,25,30,2048
2302,2022-02-16,75.2525,530477,192025,89130,427582,1239214,1155,877,25,31,2088
2303,2022-02-17,76.2825,474598,141687,83487,416398,1116170,893,603,18,26,1540
2304,2022-02-18,77.3,489106,156961,86929,419074,1152070,1012,744,19,32,1807
2305,2022-02-21,79.78,510917,176159,87392,422150,1196618,1169,799,18,31,2017
2306,2022-02-22,78.8,518191,183039,88708,423860,1213798,1242,838,19,31,2130
2307,2022-02-23,81.16,528768,197113,92750,424405,1243036,1327,845,20,32,2224
2308,2022-02-24,85.25,484221,147728,79700,416193,1127842,989,578,17,26,1610
2309,2022-02-25,83.0,489181,154033,82536,417684,1143434,1005,643,20,26,1694
2310,2022-02-28,94.6025,486454,154713,85943,417684,1144794,1017,657,20,26,1720
2311,2022-03-01,101.2325,486454,154713,85943,417684,1144794,1017,657,20,26,1720
2312,2022-03-02,106.02,480761,149029,85943,417675,1133408,962,614,20,26,1622
2313,2022-03-03,106.01,463693,130993,78192,410892,1083770,800,484,18,22,1324
2314,2022-03-04,105.0,461870,129332,78163,410701,1080066,789,478,18,22,1307
2315,2022-03-09,120.0,463929,130002,77777,411704,1083412,821,475,19,22,1337
2316,2022-03-10,118.5,468042,133030,77759,412771,1091602,842,481,19,22,1364
2317,2022-03-11,114.2525,475307,139278,77783,413812,1106180,892,517,20,23,1452
2318,2022-03-14,114.1025,477776,141227,77775,414324,1111102,918,535,20,23,1496
2319,2022-03-15,110.1,479265,142715,77767,414317,1114064,926,560,20,23,1529
2320,2022-03-16,108.0,483626,146987,77770,414409,1122792,924,558,20,23,1525
2321,2022-03-17,103.15,257468,22565,33279,268182,581494,268,179,9,12,468
2322,2022-03-18,104.82,259882,23850,33405,269437,586574,333,218,10,13,574
2323,2022-03-21,104.0,260916,24907,33428,269437,588688,388,265,11,13,677
2324,2022-03-22,103.55,263486,26883,33428,270031,593828,423,294,11,13,741
2325,2022-03-23,97.7375,275340,28014,34373,281699,619426,457,316,12,14,799
2326,2022-03-24,97.0,268868,25588,33556,276836,604848,372,232,13,17,634
2327,2022-03-25,96.0,282271,30631,33818,285458,632178,465,291,13,18,787
2328,2022-03-28,89.75,286322,33572,3817,256567,580278,478,326,11,17,832
2329,2022-03-29,85.25,291309,38236,3475,256548,589568,528,366,10,18,922
2330,2022-03-30,84.55,304223,43177,3388,264434,615222,620,421,9,18,1068
2331,2022-03-31,83.2,298095,37158,3587,264524,603364,539,334,9,15,897
2332,2022-04-01,83.95,300844,40429,4287,264702,610262,628,381,11,17,1037
2333,2022-04-04,84.0,303666,44870,6457,265253,620246,670,443,12,18,1143
2334,2022-04-05,83.3125,307882,45307,6484,269059,628732,695,465,12,19,1191
2335,2022-04-06,79.7,321231,48646,6564,279149,655590,669,493,12,20,1194
2336,2022-04-07,75.75,318307,46744,7225,278788,651064,600,375,11,14,1000
2337,2022-04-08,76.08,323363,50014,6949,280298,660624,684,419,11,17,1131
2338,2022-04-11,79.065,329620,56317,7027,280330,673294,794,458,13,20,1285
2339,2022-04-12,79.68,183573,60194,7052,130431,381250,831,483,13,19,1346
2340,2022-04-13,79.8675,189296,66105,7240,130431,393072,851,511,14,19,1395
2341,2022-04-14,80.8975,187806,62117,6863,132552,389338,698,427,12,16,1153
2342,2022-04-15,79.995,190194,64427,6835,132602,394058,779,501,12,17,1309
2343,2022-04-18,79.75,192957,67278,7428,133107,400770,817,531,12,17,1377
2344,2022-04-19,78.515,192920,67219,7406,133107,400652,818,544,12,17,1391
2345,2022-04-20,76.4125,192399,66877,7605,133127,400008,774,565,12,17,1368
2346,2022-04-21,74.785,161290,38324,5025,127991,332630,516,363,10,12,901
2347,2022-04-22,75.45,168270,45304,5025,127991,346590,655,451,10,12,1128
2348,2022-04-25,73.125,171163,48141,4984,128006,352294,698,490,9,13,1210
2349,2022-04-26,73.525,172523,49546,5034,128011,355114,733,518,9,13,1273
2350,2022-04-27,72.78,173659,50682,5034,128011,357386,766,549,9,13,1337
2351,2022-04-28,72.08,165924,42949,5036,128011,341920,596,406,9,13,1024
2352,2022-04-29,70.96,171078,48201,5144,128021,352444,654,495,9,13,1171
2353,2022-05-04,66.3,174909,51496,4608,128021,359034,663,537,9,13,1222
2354,2022-05-05,67.0,174707,51100,4418,128025,358250,621,445,9,13,1088
2355,2022-05-06,69.4025,181287,57680,4418,128025,371410,720,525,9,13,1267
2356,2022-05-11,67.2,188648,62991,4423,130080,386142,760,570,9,13,1352
2357,2022-05-12,63.3,181682,56023,4421,130080,372206,629,484,9,13,1135
2358,2022-05-13,64.545,193371,67573,4479,130277,395700,725,554,10,17,1306
2359,2022-05-16,63.4,196508,70780,4521,130249,402058,789,595,10,17,1411
2360,2022-05-17,63.6,201479,75518,4575,130536,412108,805,621,10,18,1454
2361,2022-05-18,63.445,204135,78198,4552,130489,417374,835,650,10,18,1513
2362,2022-05-19,61.905,188951,58358,4191,134784,386284,606,469,9,15,1099
2363,2022-05-20,60.2325,195722,62023,4144,137843,399732,708,594,10,16,1328
2364,2022-05-23,57.8675,201219,65093,3610,139736,409658,767,656,8,15,1446
2365,2022-05-24,56.8,203997,68236,6381,142142,420756,786,684,9,17,1496
2366,2022-05-25,59.33,210319,74513,7701,143507,436040,832,715,10,18,1575
2367,2022-05-26,65.26,207593,75004,9255,141844,433696,761,572,11,16,1360
2368,2022-05-27,66.7,228111,96028,10082,142165,476386,944,678,13,17,1652
2369,2022-05-30,62.25,243952,101520,10682,153114,509268,863,756,13,17,1649
2370,2022-05-31,61.5,246531,104032,10839,153338,514740,891,782,15,20,1708
2371,2022-06-01,61.28,251531,107804,10363,154090,523788,940,806,15,20,1781
2372,2022-06-02,61.65,231000,82136,8909,157773,479818,704,650,13,19,1386
2373,2022-06-03,60.95,241302,92118,9105,158289,500814,788,754,13,20,1575
2374,2022-06-06,61.0175,246817,98346,9859,158330,513352,867,795,14,22,1698
2375,2022-06-07,61.0425,249584,100787,9919,158716,519006,890,799,15,22,1726
2376,2022-06-08,59.4,260506,111895,10118,158729,541248,903,820,15,22,1760
2377,2022-06-09,59.35,260291,110997,9637,158931,539856,768,663,15,22,1468
2378,2022-06-10,56.8,270725,116216,9461,163970,560372,790,774,16,22,1602
2379,2022-06-14,56.6,274584,119266,8681,163999,566530,844,783,15,22,1664
2380,2022-06-15,56.96,275729,119058,8668,165339,568794,880,780,15,22,1697
2381,2022-06-16,56.5,144043,42652,12327,113718,312740,502,392,9,13,916
2382,2022-06-17,56.41,152447,49634,12493,115306,329880,648,472,10,16,1146
2383,2022-06-20,55.63,164002,68418,20474,116058,368952,741,530,12,17,1300
2384,2022-06-21,53.775,170399,75616,21547,116330,383892,783,558,11,16,1368
2385,2022-06-22,53.15,178312,83513,21792,116591,400208,784,598,11,18,1411
2386,2022-06-23,53.465,141624,48445,21187,114366,325622,622,429,9,16,1076
2387,2022-06-24,53.4,145476,52360,21207,114323,333366,734,508,10,18,1270
2388,2022-06-27,53.385,150897,57479,21006,114424,343806,745,551,11,18,1325
2389,2022-06-28,51.8,159064,60038,20545,119571,359218,721,585,10,18,1334
2390,2022-06-29,53.2375,167765,68247,20856,120374,377242,775,604,11,18,1408
2391,2022-06-30,51.45,157034,39103,11414,129345,336896,569,453,10,16,1048
2392,2022-07-01,54.5,184638,56189,12067,140516,393410,754,530,11,18,1313
2393,2022-07-04,55.24,192028,59154,13654,146528,411364,850,565,11,22,1448
2394,2022-07-05,61.15,217630,78340,16322,155612,467904,1113,561,12,22,1708
2395,2022-07-06,63.35,244472,91618,16684,169538,522312,1221,599,13,22,1855
2396,2022-07-07,61.95,211295,60512,16009,166792,454608,872,514,11,17,1414
2397,2022-07-08,60.92,220019,66323,16035,169731,472108,997,609,11,22,1639
2398,2022-07-11,58.9,227292,70117,16258,173433,487100,998,668,11,22,1699
2399,2022-07-12,58.94,233808,75191,16368,174985,500352,1022,693,11,22,1748
2400,2022-07-13,58.27,238642,80148,16420,174914,510124,1098,738,11,22,1869
2401,2022-07-14,58.3,228225,61922,16008,182311,488466,823,549,11,21,1404
2402,2022-07-15,57.165,234212,68001,16037,182248,500498,952,648,11,21,1632
2403,2022-07-18,56.34,239802,73459,16009,182352,511622,1015,689,11,22,1737
2404,2022-07-19,55.4525,246262,79939,16082,182405,524688,1007,732,12,23,1774
2405,2022-07-20,55.02,249899,83627,16108,182380,532014,1038,752,12,23,1825
2406,2022-07-21,56.6475,199658,47029,14398,167027,428112,644,484,10,15,1153
2407,2022-07-22,57.29,213382,57463,14464,170383,455692,819,609,12,19,1459
2408,2022-07-25,58.11,218430,61363,14925,171992,466710,927,657,11,19,1614
2409,2022-07-26,60.55,255573,71046,15433,199960,542012,1027,678,11,19,1735
2410,2022-07-27,59.88,268297,80958,15926,203265,568446,1083,720,14,23,1840
2411,2022-07-28,60.82,240059,56313,15670,199416,511458,759,531,11,18,1319
2412,2022-07-29,61.62,247716,63317,16008,200407,527448,893,661,14,21,1589
2413,2022-08-01,60.17,258201,73194,16734,201741,549870,916,739,14,22,1691
2414,2022-08-02,60.295,263757,78103,16676,202330,560866,1042,764,14,22,1842
2415,2022-08-03,60.58,267182,81653,16845,202374,568054,1079,770,15,22,1886
2416,2022-08-04,60.35,239475,58932,16453,196996,511856,817,561,13,18,1409
2417,2022-08-05,60.58,250627,66945,16515,200197,534284,998,663,14,23,1698
2418,2022-08-08,60.755,255525,70795,16547,201277,544144,1042,714,14,23,1793
2419,2022-08-09,60.1475,259906,74916,16651,201641,553114,1054,748,15,22,1839
2420,2022-08-10,60.665,262249,77217,16715,201747,557928,1092,739,15,23,1869
2421,2022-08-11,60.67,240965,59427,16413,197951,514756,787,581,13,18,1399
2422,2022-08-12,60.605,248386,65406,16563,199543,529898,895,724,14,19,1652
2423,2022-08-15,61.225,252348,69137,16549,199760,537794,1012,720,16,20,1768
2424,2022-08-16,60.9,254427,71601,19717,202543,548288,988,741,15,20,1764
2425,2022-08-17,60.75,259449,77446,21888,203891,562674,962,783,15,20,1780
2426,2022-08-18,59.5325,243920,62001,21656,203575,531152,695,541,13,18,1267
2427,2022-08-19,59.1,250297,68478,21776,203595,544146,832,650,13,19,1514
2428,2022-08-22,59.87,254673,72267,21687,204093,552720,933,681,13,20,1647
2429,2022-08-23,59.89,261138,77885,23009,206262,568294,1016,703,13,20,1752
2430,2022-08-24,59.8875,261774,78457,23101,206418,569750,1008,716,13,20,1757
2431,2022-08-25,60.145,244836,65884,22891,201843,535454,774,573,13,17,1377
2432,2022-08-26,60.5,253196,71757,22995,204434,552382,875,688,14,20,1597
2433,2022-08-29,60.3975,256967,75694,23217,204490,560368,918,727,14,20,1679
2434,2022-08-30,59.94,261673,80110,25117,206680,573580,900,737,14,20,1671
2435,2022-08-31,60.23,267817,80704,25218,212331,586070,938,749,14,20,1721
2436,2022-09-01,60.31,255143,68771,24642,211014,559570,730,582,13,17,1342
2437,2022-09-02,60.58,262562,76029,24823,211356,574770,816,658,14,20,1508
2438,2022-09-05,60.87,278645,88174,22703,213174,602696,850,715,15,20,1600
2439,2022-09-06,61.235,331212,100617,22700,253295,707824,885,715,15,21,1636
2440,2022-09-07,60.79,335529,102936,22706,255299,716470,898,726,15,21,1660
2441,2022-09-08,60.73,318768,89121,22522,252169,682580,740,604,15,18,1377
2442,2022-09-09,60.6,357910,91677,22610,288843,761040,796,696,15,20,1527
2443,2022-09-12,60.24,399298,103825,22622,318095,843840,803,726,16,21,1566
2444,2022-09-13,59.9,405055,106517,22663,321201,855436,823,732,16,22,1593
2445,2022-09-14,59.885,406903,107767,22695,321831,859196,822,733,16,23,1594
2446,2022-09-15,59.8,143921,20609,365,123677,288572,402,434,6,12,854
2447,2022-09-16,60.275,164659,35755,3598,132502,336514,480,546,6,12,1044
2448,2022-09-19,60.16,172893,38631,3763,138025,353312,536,599,7,14,1156
2449,2022-09-20,60.6,187663,46509,3478,144632,382282,608,611,7,13,1239
2450,2022-09-21,60.69,197372,52417,3933,148888,402610,648,631,7,14,1300
2451,2022-09-22,58.84,175701,34309,3850,145242,359102,451,484,6,13,954
2452,2022-09-23,57.92,202859,51411,5504,156952,416726,523,585,7,14,1129
2453,2022-09-26,58.395,212053,57504,5476,160025,435058,604,601,8,15,1228
2454,2022-09-27,58.4575,217826,60751,5561,162636,446774,634,619,9,16,1278
2455,2022-09-28,57.54,230681,66856,5917,169742,473196,644,637,9,16,1306
2456,2022-09-29,57.21,216171,57500,4820,163491,441982,486,466,7,10,969
2457,2022-09-30,58.45,224582,62470,5961,168073,461086,556,516,8,11,1091
2458,2022-10-03,58.86,230749,68362,6136,168523,473770,631,545,9,13,1198
2459,2022-10-04,58.95,234007,71831,6528,168704,481070,642,566,9,13,1230
2460,2022-10-05,60.1725,239741,77501,6607,168847,492696,703,574,9,14,1300
2461,2022-10-06,60.9025,217932,57801,5145,165276,446154,532,458,7,10,1007
2462,2022-10-07,61.0025,224938,64997,5344,165285,460564,610,554,9,12,1185
2463,2022-10-10,62.69,230316,70682,5477,165111,471586,680,577,9,13,1279
2464,2022-10-11,63.66,233915,75049,6332,165198,480494,693,598,9,13,1313
2465,2022-10-12,64.42,236399,77395,6307,165311,485412,733,617,10,14,1374
2466,2022-10-13,63.63,221843,62764,5996,165075,455678,643,489,8,11,1151
2467,2022-10-14,62.1075,228865,69480,5682,165067,469094,744,573,7,11,1335
2468,2022-10-17,61.65,231361,72078,5805,165088,474332,740,626,9,12,1387
2469,2022-10-18,61.575,234662,76359,6882,165185,483088,759,642,10,12,1423
2470,2022-10-19,61.735,235642,77163,6979,165458,485242,752,668,10,13,1443
2471,2022-10-20,61.4,203442,47186,6665,162921,420214,498,415,8,11,932
2472,2022-10-21,61.29,208838,51690,5796,162944,429268,595,560,7,12,1174
2473,2022-10-24,61.185,212841,60534,9665,161972,445012,664,592,8,14,1278
2474,2022-10-25,61.4875,218020,65600,9764,162184,455568,702,606,8,14,1330
2475,2022-10-26,61.75,221336,71648,12305,161993,467282,702,636,10,14,1362
2476,2022-10-27,61.725,209662,57522,9585,161725,438494,545,482,8,12,1047
2477,2022-10-28,61.52,219324,67487,11568,163405,461784,664,613,10,15,1302
2478,2022-10-31,61.4775,223602,70982,13056,165676,473316,678,679,10,15,1382
2479,2022-11-01,61.2375,227977,73321,13406,168062,482766,691,698,10,15,1414
2480,2022-11-02,61.8,230617,75680,13446,168383,488126,732,694,11,15,1452
2481,2022-11-03,62.1,217797,62771,13278,168304,462150,577,522,9,12,1120
2482,2022-11-07,61.0,225532,71835,14822,168519,480708,639,662,10,17,1328
2483,2022-11-08,60.9925,227864,74440,15131,168555,485990,667,689,11,17,1384
2484,2022-11-09,61.31,232501,77191,14413,169723,493828,717,678,11,17,1423
2485,2022-11-10,60.53,225964,69950,13517,169531,478962,579,555,10,16,1160
2486,2022-11-11,60.5375,229285,77446,17816,169655,494202,660,630,11,17,1318
2487,2022-11-14,60.55,232693,80719,17781,169755,500948,706,657,11,18,1392
2488,2022-11-15,60.4,236963,82195,17846,172614,509618,692,668,11,20,1391
2489,2022-11-16,60.35,237309,80082,14216,171443,503050,715,681,11,20,1427
2490,2022-11-17,60.53,210974,59215,15549,167308,453046,533,463,12,12,1020
2491,2022-11-18,60.4025,213101,65501,19970,167570,466142,640,556,13,17,1226
2492,2022-11-21,60.85,215167,67567,20065,167665,470464,679,584,13,17,1293
2493,2022-11-22,60.6825,218416,71943,21167,167640,479166,681,608,13,17,1319
2494,2022-11-23,60.7,222723,76468,21425,167680,488296,717,626,13,17,1373
2495,2022-11-24,60.6725,213271,65253,19298,167316,465138,567,504,11,13,1095
2496,2022-11-25,60.5025,222093,80614,26312,167791,496810,630,624,12,20,1286
2497,2022-11-28,61.2275,224938,82781,26377,168534,502630,707,646,12,20,1385
2498,2022-11-29,61.0225,225383,84279,27408,168512,505582,699,673,12,21,1405
2499,2022-11-30,60.99,226192,85590,27909,168511,508202,716,691,12,21,1440
2500,2022-11-30,60.99,226192,85590,27909,168511,508202,716,691,12,21,1440
2501,2022-12-01,61.49,219296,76502,25310,168104,489212,621,552,12,14,1199
2502,2022-12-02,62.0,228026,84958,25615,168683,507282,732,636,13,15,1396
2503,2022-12-05,62.35,234113,91347,26368,169134,520962,785,660,14,16,1475
2504,2022-12-06,63.085,238609,95826,26394,169177,530006,790,663,15,15,1483
2505,2022-12-07,62.75,243596,100351,26310,169555,539812,822,683,15,19,1539
2506,2022-12-08,62.7725,237080,92972,25749,169857,525658,655,595,13,18,1281
2507,2022-12-09,62.43,241899,96964,27663,172598,539124,699,665,15,18,1397
2508,2022-12-12,62.8,246911,108161,33997,172747,561816,752,691,16,18,1477
2509,2022-12-13,62.85,251248,110662,35304,175890,573104,766,699,16,18,1499
2510,2022-12-14,63.995,262475,119323,35885,179037,596720,820,682,18,21,1541
2511,2022-12-15,64.3525,31089,32985,10328,8432,82834,401,402,8,12,823
2512,2022-12-16,64.65,42962,39411,11573,15124,109070,551,498,9,12,1070
2513,2022-12-19,67.72,68354,61893,12876,19337,162460,777,554,12,13,1356
2514,2022-12-20,68.875,80553,68707,12957,24803,187020,887,605,13,16,1521
2515,2022-12-21,70.995,92153,78865,14244,27532,212794,991,639,14,16,1660
2516,2022-12-22,68.95,72250,51345,11114,32019,166728,702,485,11,11,1209
2517,2022-12-23,70.2,79534,58280,11990,33244,183048,798,606,13,13,1430
2518,2022-12-26,69.29,81449,57473,10791,34767,184480,847,652,15,14,1528
2519,2022-12-27,70.4,85531,59331,9486,35686,190034,898,647,16,14,1575
2520,2022-12-28,72.19,98041,73790,16876,41127,229834,976,641,15,14,1646
2521,2022-12-29,72.175,70345,42094,8937,37188,158564,676,442,13,10,1141
2522,2022-12-30,69.9,79014,51132,10237,38119,178502,772,591,14,18,1395
2523,2023-01-03,71.1375,84894,56843,10239,38290,190266,851,606,14,18,1489
2524,2023-01-04,72.0,93194,64347,9855,38702,206098,895,623,14,18,1550
2525,2023-01-05,72.18,78352,50341,9097,37108,174898,734,489,13,11,1247
2526,2023-01-06,72.1225,86942,59035,9322,37229,192528,858,592,14,17,1481
2527,2023-01-09,69.99,92554,64838,10459,38175,206026,869,700,16,18,1603
2528,2023-01-10,69.8,99063,71443,10740,38360,219606,893,740,16,18,1667
2529,2023-01-11,68.7325,102991,76030,11315,38276,228612,897,779,16,18,1710
2530,2023-01-12,67.7575,88147,62341,11258,37064,198810,751,584,14,10,1359
2531,2023-01-13,68.7875,100693,74816,11481,37358,224348,882,664,15,13,1574
2532,2023-01-16,68.43,104634,78620,11552,37566,232372,929,695,15,14,1653
2533,2023-01-17,69.15,108413,82574,11902,37741,240630,932,697,16,15,1660
2534,2023-01-18,68.7475,110468,85156,12321,37633,245578,943,714,16,15,1688
2535,2023-01-19,68.8,66903,44458,6846,29291,147498,613,436,12,10,1071
2536,2023-01-20,68.83,70450,50190,6987,27247,154874,733,567,14,15,1329
2537,2023-01-23,68.925,81288,55412,7163,33039,176902,805,612,14,15,1446
2538,2023-01-24,69.0,89635,58661,7988,38962,195246,813,625,14,17,1469
2539,2023-01-25,69.305,92962,60312,7796,40446,201516,831,628,14,17,1490
2540,2023-01-26,69.265,81413,53324,7777,35866,178380,642,498,13,13,1166
2541,2023-01-27,69.46,86328,57893,7944,36379,188544,757,580,14,17,1368
2542,2023-01-30,70.405,90239,61633,8107,36713,196692,854,614,15,17,1500
2543,2023-01-31,69.82,107617,74518,8892,41991,233018,858,650,15,17,1540
2544,2023-02-01,70.1975,113711,80208,9026,42529,245474,880,679,15,17,1591
2545,2023-02-02,70.455,93865,63041,7573,38397,202876,704,547,14,15,1280
2546,2023-02-03,70.6,112911,68873,8496,52534,242814,795,651,16,17,1479
2547,2023-02-06,70.95,133254,82191,8672,59735,283852,846,645,16,18,1525
2548,2023-02-07,71.15,147166,85369,8983,70780,312298,864,664,17,19,1564
2549,2023-02-08,72.3025,157943,91399,8435,74979,332756,940,665,17,20,1642
2550,2023-02-09,73.0,157991,87587,8567,78971,333116,789,557,17,18,1381
2551,2023-02-10,73.39,167600,96493,8627,79734,352454,894,656,17,20,1587
2552,2023-02-13,73.825,179143,100912,8547,86778,375380,964,682,18,20,1684
2553,2023-02-14,73.8,191468,108825,9163,91806,401262,956,700,18,21,1695
2554,2023-02-15,74.5725,198134,113583,9607,94158,415482,1004,715,18,21,1758
2555,2023-02-16,74.855,155084,74378,8287,88993,326742,793,492,15,13,1313
2556,2023-02-17,74.29,169048,82919,8890,95019,355876,836,617,14,16,1483
2557,2023-02-20,74.5,178065,92248,9292,95109,374714,920,631,16,18,1585
2558,2023-02-21,75.0475,186447,98953,9670,97164,392234,989,642,16,19,1666
2559,2023-02-22,75.0,170398,80526,8383,98255,357562,803,487,15,14,1319
2560,2023-02-24,76.13,180748,91972,8531,97307,378558,963,590,17,17,1587
2561,2023-02-27,74.6025,207450,112280,11495,106665,437890,948,685,17,21,1671
2562,2023-02-28,74.97,211666,116432,11600,106834,446532,998,698,17,21,1734
2563,2023-03-01,75.15,218670,124009,14123,108784,465586,1025,701,18,21,1765
2564,2023-03-02,75.3175,195649,105937,11100,100812,413498,866,555,17,13,1451
2565,2023-03-03,75.6325,201120,111063,11122,101179,424484,963,630,18,15,1626
2566,2023-03-06,75.445,206144,115360,11153,101937,434594,1011,671,17,16,1715
2567,2023-03-07,76.0225,212386,120275,10978,103089,446728,1026,667,17,17,1727
2568,2023-03-09,75.845,208065,111957,15076,111184,446282,877,560,16,17,1470
2569,2023-03-10,76.1,214645,117771,15661,112535,460612,963,625,17,18,1623
2570,2023-03-13,75.0,234036,125711,16073,124398,500218,979,669,17,20,1685
2571,2023-03-14,75.32,237053,132174,16013,120892,506132,1023,669,17,19,1728
2572,2023-03-15,75.985,248185,140962,16442,123665,529254,1045,688,19,19,1771
2573,2023-03-16,76.4,52054,42041,5007,15020,114122,554,420,9,9,992
2574,2023-03-17,77.06,67347,55383,5104,17068,144902,683,510,10,14,1217
2575,2023-03-20,77.17,81222,68527,9839,22534,182122,781,554,13,14,1362
2576,2023-03-21,76.66,88874,70422,10273,28725,198294,812,576,13,14,1415
2577,2023-03-22,77.0575,96139,76117,10340,30362,212958,852,583,13,15,1463
2578,2023-03-23,76.0,73231,49652,9889,33468,166240,574,436,11,11,1032
2579,2023-03-24,77.075,86448,57634,10653,39467,194202,743,508,14,14,1279
2580,2023-03-27,76.68,92426,63525,10917,39818,206686,802,548,14,13,1377
2581,2023-03-28,76.9,100671,71443,12299,41527,225940,824,571,15,14,1424
2582,2023-03-29,77.155,106905,76064,11577,42418,236964,880,583,14,15,1492
2583,2023-03-30,77.08,75774,55991,10456,30239,172460,649,447,11,10,1117
2584,2023-03-31,77.5975,91311,66478,10658,35491,203938,804,537,13,15,1369
